ং	ŋ
অ	ɔ
অ	o
অইলদা	ɔ i l . d̪ a
অকর্তা	ɔ . k ɔ r . t̪ a
অকর্মা	ɔ . k ɔ r . m a
অকর্মিষ্ঠ	ɔ . k o r . m i ʃ . ʈʰ o
অকর্ষিত	ɔ . k o r . ʃ i . t̪ o
অকল	ɔ . k ɔ l
অকলঙ্ক	ɔ . k ɔ . l o ŋ . k o
অকলঙ্কিত	ɔ . k ɔ . l o ŋ . k i . t̪ o
অকলঙ্কিতা	ɔ . k ɔ . l o ŋ . k i . t̪ a
অকলঙ্কিনী	ɔ . k ɔ . l o ŋ . k i . n i
অকলঙ্কী	ɔ . k ɔ . l o ŋ . k i
অকলমন্দ	ɔ . k ɔ l . m ɔ n d̪
অকলমন্দ	ɔ . k ɔ l . m ɔ n . d̪ o
অকলুষ	ɔ . k o . l u ʃ
অকলুষিত	ɔ . k o . l u . ʃ i . t̪ o
অকল্ক	ɔ . k ɔ l . k o
অকল্কা	ɔ . k ɔ l . k a
অকল্পনা	ɔ . k ɔ l . p o . n a
অকল্পনীয়	ɔ . k ɔ l . p o . n i o
অকল্পিত	ɔ . k o l . p i . t̪ o
অকল্মষ	ɔ . k ɔ l . m o ʃ
অকল্যাণ	ɔ . k o l . l a n
অকল্যাণকর	ɔ . k o l . l a n . k ɔ r
অকল্যাণকারিণী	ɔ . k o l . l a n . k a . r i . n i
অকষ্ট	ɔ . k ɔ ʃ . ʈ o
অকষ্টকল্পনা	ɔ . k ɔ ʃ . ʈ o . k ɔ l . p o . n a
অকষ্টকল্পিত	ɔ . k ɔ ʃ . ʈ o . k o l . p i . t̪ o
অকষ্টবদ্ধ	ɔ . k ɔ ʃ . ʈ o . b ɔ d̪ . d̪ʰ o
অকস্মাৎ	ɔ . k o ʃ . ʃ ã t̪
অকাজ	ɔ . k a ɟ
অকাট	ɔ . k a ʈ
অকাট্য	ɔ . k a ʈ . ʈ ɔ
অকাঠ	ɔ . k a ʈʰ
অকাঠা	ɔ . k a . ʈʰ a
অকাণ্ড	ɔ . k a n . ɖ o
অকাণ্ডে	ɔ . k a n . ɖ e
অকাতর	ɔ . k a . t̪ o r
অকাতরে	ɔ . k a . t̪ o . r e
অকাপট্য	ɔ . k a . p o ʈ . ʈ o
অকাম	ɔ . k a m
অকাম্য	ɔ . k a m . m o
অকায়	ɔ . k aʲ
অকার	ɔ . k a r
অকারণ	ɔ . k a . r o n
অকারণে	ɔ . k a . r o . n e
অকারত	ɔ . k a . r o t̪
অকারাদি	ɔ . k a . r a . d̪ i
অকারান্ত	ɔ . k a . r a n . t̪ o
অকার্য	ɔ . k a r ɟ . ɟ o
অকার্যকর	ɔ . k a r . ɟ o . k ɔ r
অকার্যকরী	ɔ . k a r . ɟ o . k o . r i
অকার্যকারিতা	ɔ . k a r ɟ . ɟ o . k a . r i . t̪ a
অকাল	ɔ . k a l
অকালকুষ্মাণ্ড	ɔ . k a l . k u ʃ . ʃ ã n . ɖ o
অকালকুষ্মাণ্ড	ɔ . k a l . k u ʃ . m a n . ɖ o
অকালজ	ɔ . k a . l o . ɟ o
অকালজ	ɔ . k a . l ɔ ɟ
অকালজাত	ɔ . k a l . ɟ a . t̪ o
অকালপক্ব	ɔ . k a l . p ɔ k . k o
অকালপক্বতা	ɔ . k a l . p ɔ k . k ɔ . t̪ a
অকালবর্ষণ	ɔ . k a l . b ɔ r . ʃ ɔ n
অকালবার্ধক্য	ɔ . k a l . b a r . d̪ʰ o k . k o
অকালবৃদ্ধ	ɔ . k a l . b r i d̪ . d̪ʰ o
অকালবোধন	ɔ . k a l . b o . d̪ʰ o n
অকালমৃত্যু	ɔ . k a l . m r i t̪ . t̪ u
অকালসন্ধ্যা	ɔ . k a l . ʃ o n . d̪ʱ a
অকালী	ɔ . k a l i
অকালে	ɔ . k a . l e
অকাল্পনিক	ɔ . k a l . p o . n i k
অকিঞ্চন	ɔ . k i n . c ɔ n
অকিঞ্চনতা	ɔ . k i n . c ɔ . n ɔ . t̪ a
অকিঞ্চনত্ব	ɔ . k i n . c ɔ . n ɔ t̪ . t̪ o
অকিঞ্চিৎ	ɔ . k i n . c i t̪
অকিঞ্চিৎকর	ɔ . k i n . c i t̪ . k ɔ r
অকিঞ্চিৎকরতা	ɔ . k i n . c i t̪ . k ɔ . r ɔ . t̪ a
অকীর্ত	ɔ . k i r . t̪ ɔ
অকীর্তি	ɔ . k i r . t̪ i
অকীর্তিকর	ɔ . k i r t̪ . t̪ i . k ɔ r
অকীর্তিত	ɔ . k i r . t̪ i . t̪ o
অকু	o . k u
অকুআত	o . k u͡a̯ t̪
অকুটিলতা	ɔ . k u . ʈ i . l ɔ . t̪ a
অকুটিলা	ɔ . k u . ʈ i . l a
অকুণ্ঠ	ɔ . k u n . ʈ h o
অকুণ্ঠচিত্ত	ɔ . k u n . ʈ h o . c i t̪ . t̪ o
অকুণ্ঠচিত্তে	ɔ . k u n . ʈ h o . c i t̪ . t̪ e
অকুণ্ঠিত	ɔ . k u n . ʈ h i . t̪ o
অকুণ্ঠিতচিত্ত	ɔ . k u n . ʈ h i . t̪ o . c i t̪ . t̪ o
অকুণ্ঠিতচিত্তে	ɔ . k u n . ʈ h i . t̪ o . c i t̪ . t̪ e
অকুণ্ঠিতা	ɔ . k u n . ʈ h i . t̪ a
অকুতোভয়	ɔ . k u . t̪ o . bʱ ɔʲ
অকুতোভয়তা	ɔ . k u . t̪ o . bʱ ɔ .ʲ ɔ . t̪ a
অকুতোভয়া	ɔ . k u . t̪ o . bʱ ɔ .ʲ a
অকুফ	o . k u pʱ
অকুল	ɔ . k u l
অকুলন	ɔ . k u . l ɔ n
অকুলান	ɔ . k u . l a n
অকুলীন	ɔ . k u . l i n
অকুস্থল	o . k u s . t̪ʰ ɔ l
অকুস্থলে	o . k u s . t̪ʰ ɔ . l e
অকুস্থান	o . k u s . t̪ʰ a n
অকূল	ɔ . k u l
অকৃত	ɔ . k r i . t̪ o
অকৃতকর্ম	ɔ . k r i . t̪ o . k ɔ r . m ɔ
অকৃতকর্মা	ɔ . k r i . t̪ o . k ɔ r . m a
অকৃতকার্য	ɔ . k r i . t̪ o . k a r . ɟ ɔ
অকৃতকার্যতা	ɔ . k r i . t̪ o . k a r . ɟ o . t̪ a
অকৃতঘ্ন	ɔ . k r i . t̪ ɔ ɡʰ . n o
অকৃতঘ্নতা	ɔ . k r i . t̪ ɔ ɡʰ . n o . t̪ a
অকৃতজ্ঞ	ɔ . k r i . t̪ ɔ ɡ . ɡ õ
অকৃতজ্ঞতা	ɔ . k r i . t̪ ɔ ɡ . ɡ õ . t̪ a
অকৃতদার	ɔ . k r i . t̪ o . d̪ a r
অকৃতধী	ɔ . k r i . t̪ o . d̪ʰ i
অকৃতনামা	ɔ . k r i . t̪ o . n a . m a
অকৃতনামী	ɔ . k r i . t̪ o . n a . m i
অকৃতনাম্নী	ɔ . k r i . t̪ o . n a m . n i
অকৃতবিদ্য	ɔ . k r i . t̪ o . b i d̪ . d̪ o
অকৃতাত্মা	ɔ . k r i . t̪ a t̪ . t̪ ã
অকৃতাদর	ɔ . k r i . t̪ a . d̪ ɔ r
অকৃতাপরাধ	ɔ . k r i . t̪ a . p o . r a d̪ʱ
অকৃতার্থ	ɔ . k r i . t̪ a r . t̪ʰ o
অকৃতিত্ব	ɔ . k r i . t̪ i t̪ . t̪ o
অকৃতী	ɔ . k r i . t̪ i
অকৃতোদ্বাহ	ɔ . k r i . t̪ o d̪ . b a . ɦ o
অকৃতোদ্বাহা	ɔ . k r i . t̪ o d̪ . b a . ɦ a
অকৃত্য	ɔ . k r i t̪ . t̪ o
অকৃত্যকারী	ɔ . k r i t̪ . t̪ o . k a . r i
অকৃত্রিম	ɔ . k r i t̪ . t̪ r i m
অকৃত্রিমতা	ɔ . k r i t̪ . t̪ r i . m ɔ . t̪ a
অকৃপ	ɔ . k r i . p o
অকৃপণ	ɔ . k r i . p ɔ n
অকৃপণতা	ɔ . k r i . p ɔ . n ɔ . t̪ a
অকৃপা	ɔ . k r i . p a
অকৃষ্ট	ɔ . k r i ʃ . ʈ o
অকৃষ্টপচ্য	ɔ . k r i ʃ . ʈ o . p o c . c o
অকৃষ্ণ	ɔ . k r i ʃ . n o
অকৃষ্ণকর্মা	ɔ . k r i ʃ . n o . k ɔ r . m a
অকেজো	ɔ . k e . ɟ o
অকেলাস	ɔ . k e . l a ʃ
অকেলাস	ɔ . k e . l a s
অকেশ	ɔ . k e ʃ
অকেশা	ɔ . k e . ʃ a
অকেশিনী	ɔ . k e . ʃ i . n i
অকেশী	ɔ . k e . ʃ i
অকৈতব	ɔ . k o i . t̪ ɔ b
অকোপ	ɔ . k o p
অকোপিত	ɔ . k o . p i . t̪ o
অকোপী	ɔ . k o . p i
অকোবিদ	ɔ . k o . b i d̪
অকৌশল	ɔ . k o u . ʃ ɔ l
অক্কা	ɔ k . k a
অক্কাপ্রাপ্তি	ɔ k . k a . p r a p . t̪ i
অক্টোপাস	ɔ k . ʈ o . p a s
অক্টোপাস	ɔ k . ʈ o . p a ʃ
অক্রম	ɔ k . k r ɔ m
অক্রমিক	ɔ k . k r ɔ . m i k
অক্রিয়	ɔ k . k r i .ʲ o
অক্রিয়কর্মা	ɔ k . k r iʲ o . k ɔ r . m a
অক্রিয়তা	ɔ k . k r iʲ o . t̪ a
অক্রিয়ত্ব	ɔ k . k r iʲ ɔ t̪ . t̪ o
অক্রিয়া	ɔ k . k r iʲ a
অক্রিয়াচরণ	ɔ k . k r iʲ a . c ɔ . r o n
অক্রিয়ানিষ্ঠ	ɔ k . k r iʲ a . n i ʃ . ʈʰ o
অক্রিয়ান্বিত	ɔ k . k r iʲ a n . n i . t̪ o
অক্রিয়ারত	ɔ k . k r iʲ a . r ɔ . t̪ o
অক্রিয়াসক্ত	ɔ k . k r iʲ a . ʃ ɔ k . t̪ o
অক্রীত	ɔ k . k r i . t̪ o
অক্রুদ্ধ	ɔ k . k r u d̪ . d̪ʰ o
অক্রূর	ɔ k . k r u r
অক্রূর	ɔ k . k r u . r o
অক্রেয়	ɔ k . k r eʲ o
অক্রেয়তা	ɔ k . k r eʲ o . t̪ a
অক্রোধ	ɔ k . k r o d̪ʰ
অক্রোধিত	ɔ k . k r o . d̪ʰ i . t̪ o
অক্রোধী	ɔ k . k r o . d̪ʰ i
অক্লম	ɔ k . k l o m
অক্লান্ত	ɔ k . k l a n . t̪ o
অক্লান্তকর্মা	ɔ k . k l a n . t̪ o . k ɔ r . m a
অক্লিষ্ট	ɔ . k l i ʃ . ʈ o
অক্লিষ্টকর্মা	ɔ . k l i ʃ . ʈ o . k ɔ r . m a
অক্লিষ্টশোভা	ɔ . k l i ʃ . ʈ o . ʃ o . bʱ a
অক্লিষ্টস্নেহ	ɔ . k l i ʃ . ʈ o . s n e . h o
অক্লীব	ɔ k . k l i b
অক্লীব	ɔ k . k l i . b o
অক্লেশ	ɔ k . k l e ʃ
অক্লেশে	ɔ k . k l e . ʃ e
অক্ষ	ɔ k . kʰ o
অক্ষক্রীড়া	ɔ k . kʰ o . k r i . ɽ a
অক্ষটি	ɔ k . kʰ o . ʈ i
অক্ষত	ɔ k . kʰ ɔ . t̪ o
অক্ষতদেহ	ɔ k . kʰ ɔ . t̪ o . d̪ e . h o
অক্ষতদেহে	ɔ k . kʰ ɔ . t̪ o . d̪ e . h e
অক্ষতযোনি	ɔ k . kʰ ɔ . t̪ o . ɟ o . n i
অক্ষতশরীর	ɔ k . kʰ ɔ . t̪ o . ʃ o . r i r
অক্ষতশরীরে	ɔ k . kʰ ɔ . t̪ o . ʃ o . r i . r e
অক্ষপাদ	ɔ k . kʰ o . p a d̪
অক্ষবাট	ɔ k . kʰ o . b a ʈ
অক্ষবিদ	ɔ k . kʰ o . b i d̪
অক্ষবিৎ	ɔ k . kʰ o . b i t̪
অক্ষবৃত্ত	ɔ k . kʰ o . b r i t̪ . t̪ o
অক্ষবেত্তা	ɔ k . kʰ o . b e t̪ . t̪ a
অক্ষম	ɔ k . kʰ ɔ m
অক্ষম	ɔ k . kʰ o m
অক্ষমতা	ɔ k . kʰ o . m o . t̪ a
অক্ষমা	ɔ k . kʰ ɔ . m a
অক্ষমালা	ɔ k . kʰ o . m a . l a
অক্ষয়	ɔ k . kʰ ɔʲ
অক্ষয়কীর্তি	ɔ k . kʰ ɔʲ . k i r . t̪ i
অক্ষয়বট	ɔ k . kʰ ɔʲ . b ɔ ʈ
অক্ষয়লোক	ɔ k . kʰ ɔʲ . l o k
অক্ষর	ɔ k . kʰ ɔ r
অক্ষর	ɔ k . kʰ o r
অক্ষর	o k . kʰ o r
অক্ষর	ɔ k . kʰ ɔ r
অক্ষরজীবক	ɔ k . kʰ ɔ r . ɟ i . b ɔ k
অক্ষরজীবিক	ɔ k . kʰ ɔ r . ɟ i . b i k
অক্ষরজীবী	ɔ k . kʰ ɔ r . ɟ i . b i
অক্ষরজ্ঞান	ɔ k . kʰ ɔ r . ɡ æ n
অক্ষরডম্বর	ɔ k . kʰ ɔ r . ɖ ɔ m . b ɔ r
অক্ষরপরিচয়	ɔ k . kʰ ɔ r . p o . r i . c ɔʲ
অক্ষরবিন্যাস	ɔ k . kʰ ɔ r . b i n . n a ʃ
অক্ষরবৃত্ত	ɔ k . kʰ ɔ r . b r i t̪ . t̪ ɔ
অক্ষরমালা	ɔ k . kʰ ɔ r . m a . l a
অক্ষরযোজক	ɔ k . kʰ ɔ r . ɟ o . ɟ ɔ k
অক্ষরান্তরীকরণ	ɔ k . kʰ ɔ . r a n . t̪ o . r i . k ɔ . r ɔ n
অক্ষরেখা	ɔ k . kʰ o . r e . kʰ a
অক্ষশক্তি	ɔ k . kʰ o . ʃ o k . t̪ i
অক্ষসূত্র	ɔ k . kʰ o . ʃ u t̪ . t̪ r o
অক্ষহার	ɔ k . kʰ o . h a r
অক্ষাংশ	ɔ k . kʰ a ŋ . ʃ o
অক্ষার	ɔ k . kʰ a r
অক্ষারলবণ	ɔ k . kʰ a r . l ɔ . b ɔ n
অক্ষি	o k . kʰ i
অক্ষিকাচ	o k . kʰ i . k a c
অক্ষিকোটর	o k . kʰ i . k o . ʈ ɔ r
অক্ষিগত	o k . kʰ i . ɡ ɔ . t̪ ɔ
অক্ষিগোলক	o k . kʰ i . ɡ o . l o k
অক্ষিণ্ণ	ɔ k . kʰ i n . n ɔ
অক্ষিপক্ষ্ম	o k . kʰ i . p ɔ k . k h ɔ
অক্ষিপট	o k . kʰ i . p ɔ ʈ
অক্ষিপটল	o k . kʰ i . p ɔ . ʈ o l
অক্ষিপুট	o k . kʰ i . p u ʈ
অক্ষিভিষক	o k . kʰ i . bʱ i . ʃ ɔ k
অক্ষিলোম	o k . kʰ i . l o m
অক্ষিশালাক্য	o k . kʰ i . ʃ a . l a k . k o
অক্ষীয়	o k . kʰ iʲ o
অক্ষুণ্ণ	ɔ k . kʰ u n . n ɔ
অক্ষুণ্ণচিত্ত	ɔ k . kʰ u n . n o . c i t̪ . t̪ o
অক্ষুণ্ণচিত্তে	ɔ k . kʰ u n . n o . c i t̪ . t̪ e
অক্ষুব্ধ	ɔ k . kʰ u b . d̪ʱ o
অক্ষুব্ধচিত্ত	ɔ k . kʰ u b . d̪ʱ o . c i t̪ . t̪ o
অক্ষুব্ধচিত্তে	ɔ k . kʰ u b . d̪ʱ o . c i t̪ . t̪ e
অক্ষুভিত	ɔ k . kʰ u . bʱ i . t̪ o
অক্ষুভিতচিত্ত	ɔ k . kʰ u . bʱ i . t̪ o . c i t̪ . t̪ o
অক্ষুভিতচিত্তে	ɔ k . kʰ u . bʱ i . t̪ o . c i t̪ . t̪ e
অক্ষেমা	ɔ k . kʰ e . m a
অক্ষোভ	ɔ k . kʰ o bʱ
অক্ষোভিত	ɔ k . kʰ o . bʱ i . t̪ o
অক্ষোভে	ɔ k . kʰ o . bʱ e
অক্ষোভ্য	ɔ k . kʰ o b . bʱ o
অক্ষৌহিণী	ɔ k . kʰ o u . h i . n i
অক্সাইড	ɔ k . s a i ɖ
অক্সিজেন	ɔ k . s i . ɟ e n
অক্সিডেশন	ɔ k . s i . ɖ e . ʃ ɔ n
অখণ্ড	ɔ . kʰ ɔ n . ɖ o
অখণ্ডতা	ɔ . kʰ ɔ n . ɖ o . t̪ a
অখণ্ডনীয়	ɔ . kʰ ɔ n . ɖ o . n iʲ o
অখণ্ডনীয়তা	ɔ . kʰ ɔ n . ɖ o . n iʲ ɔ . t̪ a
অখণ্ডিত	ɔ . kʰ o n . ɖ i . t̪ o
অখণ্ড্য	ɔ . kʰ ɔ n . ɖ o
অখন	ɔ . kʰ o n
অখর্ব	ɔ . kʰ ɔ r . b o
অখল	ɔ . kʰ ɔ l
অখাত	ɔ . kʰ a t̪
অঙ্গ	ˈɔ ŋ ɡ o
অঙ্গার	ˈɔ ŋ ɡ a r
অজগর	ɔ . d͡ʒ ɔ . ɡ ɔ ɾ
অঞ্চল	ɔ n t ʃ ɔ l
অতিমঙ্গল্য	o t i m o ŋ ɡ o lː ɔ
অথচ	ɔ t̪ʰ ɔ t͡ʃ o
অথবা	ɔ t̪ʰ ɔ b ɑ
অনুবাদক	ɔ n u b a d̪ ɔ k
অনুভব	ɔ n u bʱ ɔ b
অনুভব	ɔ n u v ɔ b
অনেক	ɔ n e k
অন্ন	ɔ nː ɔ
অপারেশন	ɔ . p ɑ . ɾ e . ʃ ɔ n
অভদ্র	ɔ . bʱ ɔ d̪ . ɾ ɔ
অভদ্র	ɔ̜ bʱ ɔ̜ d̪ː ɾ o
অভদ্র	ɔ̜ bʱ ɔ̜ d̪ː ɾ o
অভিধান	ɔ bʱ i dʱ a n
অভিধান	ɔ b i d a n
অভিধান	ɔ v i dʱ a n
অভিধান	ɔ v i d a n
অভিযোগ	ɔ bʱ i d ʒ o ɡ
অভিযোগ	ɔ v i d ʒ o ɡ
অমার্জনীয়	ɔ . m ɑ ɾ . d͡ʒ ɔ . n i . ɔ
অরণ্য	ɔ ɾ o nː o
অরবিন্দ	ɔ . ɾ ɔ . b i n . d̪ ɔ
অর্থাৎ	ɔ ɾ . t̪ʰ ɑ t̪
অলইদ	ɒ . l ɔ i d̪
অশনি	ɔ ʃ o n i
অশোক	ɔ . ʃ o k
অশোত	ɔ ʃ o t
অশ্বত্থ	ɔ ʃ w ɔ tːʰ ɔ
অশ্বত্থ	ɔ ʃː ɔ tʰː ɔ
অসভ্য	ɔ . ʃ ɔ b . bʱ ɔ
অসভ্য	ɔ̜ s̠ o bːʱ o
অসভ্য	ɔ̜ s̠ o bːʱ o
অসুস্থ	ɔ ʃ u s tʰ ɔ
অসুস্থতা	ɔ ʃ u s tʰ ɔ t a
অস্ত্রচিকিৎসা	ɔ ʃ . t̪ ɾ ɔ . t͡ʃ i . k i t̪ . ʃ ɑ
অস্ত্রচিকিৎসা	ɔ̜ s̠ t̪ ɾ o t͡ʃ i k i t̪ s̠ ä
অস্ত্রচিকিৎসা	ɔ̜ s̠ t̪ ɾ o t͡ʃ i k i t̪ s̠ ä
অস্ত্রোপচার	ɔ ʃ . t̪ ɾ o . p ɔ . t͡ʃ ɑ ɾ
অস্ত্রোপচার	ɔ̜ s̠ t̪ ɾ o p ɔ̜ t͡ʃ ä ɾ
অস্ত্রোপচার	ɔ̜ s̠ t̪ ɾ o p ɔ̜ t͡ʃ ä ɾ
অহরহ	ɔ . ɦ ɔ . ɾ ɔ . ɦ ɔ
অ্যানথ্রাক্স	æ n t̪ʰ ɾ ɑ k s
আ	a
আঁই	ã i
আঁডু	a . d̺ u
আঁডু	ã . d̺ u
আঁরে	ã . ɾ e
আঁস	a ʃ
আংশিক	a ŋ ʃ i k
আইচ্ছা	a i t͡ɕ . t͡ɕ a
আইজ	a i z
আইজকাইল	a i z . k a i l
আইজকো	a i z . k ɔ
আইজ্যা	a i d͡ʑ . d͡ʑ a
আইন	a i n
আকাট	a . k a ʈ
আকাঠ	a . k a ʈʰ
আকাঠা	a . k a . ʈʰ a
আকাম	a . k a m
আকালী	a . k a . l i
আকাশ	a k a ʃ
আখ	a kʰ
আখাত	a . kʰ a t̪
আগামী	ɑ . ɡ ɑ . m i
আগুন	a ɡ u n
আগ্রাবাদ	a ɡ ɾ a b a d
আচরণ	ˈa t ʃ o ˌɾ ɔ n
আচরণ	ˈa t ʃ o ˌɽ ɔ n
আছে	a t ʃʰ e
আছে	a s e
আজ	a d ʒ
আজব	a d ʒ o b
আজান	a . d ʒ a n
আজান	a . z a n
আঞ্চলিক	a n t ʃ ɔ l i k
আঞ্চলিকতা	a n t ʃ ɔ l i k ɔ t̪ a
আডা	a . d̺ a
আঢ়	a ɾ
আণ	ɑ . n ɔ
আণ্ডা	a ɳ ɖ a
আতকা	a t̪ . k a
আতশ	a t̪ o ʃ
আতশবাজি	a t̪ o ʃ b a z i
আতশবাজি	a t̪ o ʃ b a d ʒ i
আদমশুমার	ˈɑ . d̪ ɔ m ˌʃ u . m ɑ ɾ
আদা	ɑ d̪ ɑ
আদালত	a d̪ a l ɔ t̪
আদেশ	ɑ d̪ e ʃ
আন্তর্জাল	ɑ n . t̪ ɔ ɾ . d͡ʒ ɑ l
আন্দাজ	a n d̪ a z
আন্ধাইর	a n . d̪ʱ a i ɾ
আপনে	a p . n e
আপনে	a ɸ . n e
আপনে	a p . n e
আফসোস	a f s o s
আফসোস	a pʰ ʃ o ʃ
আবহাওয়া	a b o h a w a
আবির	ˈä . b i ɾ
আবুধ	a . b u d̪ʱ
আব্বা	a b b a
আব্বু	a b b u
আম	ɑ m
আমড়া	a m ɽ a
আমরার	a m . ɾ a ɾ
আমলকী	a m l o k i
আমাগর	a . m a . ɡ ɔ ɾ
আমাদের	ɑ ˈm ɑ d e r
আমার	ˈɑː ˌm ɑ ɹ
আম্মে	a m . m e
আর	a r
আর	a ɹ
আরণ্যক	a ɾ o nː o k
আর্তব	ɑ ɾ . t̪ ɔ b
আলাপ	a l a p
আলো	a l o
আশমান	ɑ ʃ . m ɑ n
আশুতোষ	a ʃ u t o ʃ
আশোত	a ʃ o t
আষ্ট	a ʃ . t̺ ɔ
আসিফ	a s i f
ই	i
ইংরেজি	i ŋ ɾ e d ʒ i
ইংরেজি	i ŋ ɽ e z i
ইংরেজি	i ŋ ɽ e d z i
ইউক্রেন	i u . k ɾ e n
ইখান	i . kʰ a n
ইখান	i . ɦ a n
ইগা	i . ɡ a
ইজ্জত	i z z o t̪
ইজ্জত	i d ʒ d ʒ o t̪
ইটানো	i ʈ a n o
ইডা	i . d̺ a
ইতিহাস	i . t̪ i . ɦ ɑ ʃ
ইন	i n
ইনকিলাব	i n . k i . l ɑ b
ইনকিলাবি	i n . k i . l ɑ . b i
ইনশাআল্লাহ্	i n ʃ a . a l l aʱ
ইন্দু	i n . d̪ u
ইয়ান	i a n
ইলিশ	i l i ʃ
ঈ	i
ঈগল	i ɡ ɔ l
উ	u
উইল	u i̯ l
উক্কা	u k . k a
উঙ্ঘানো	u ŋ . ɡʱ a . n ɔ
উট	u ʈ
উদিন	u . d̪ i n
উদ্বোধন	u d̪ . b o . d̪ʱ ɔ n
উন্দূর	u n d̪ u ɾ
উপজেলা	u p o z e l a
উপজেলা	u p o d ʒ e l a
উপত্যকা	u p ɔ t̪ː ɔ k a
উপন্যাস	u . p ɔ n . n ɑ ʃ
উপভাষা	u . p ɔ . bʱ ɑ . ʃ ɑ
উপাচার্য	u . p ɑ . t͡ʃ ɑ ɾ . d͡ʒ ɔ
উপাচার্য	u p ä t͡ʃ ä ɾ d͡ʒ o
উপাচার্য	u p ä t͡ʃ ä ɾ d͡ʒ o
উয়াস	u a ʃ
উলঙ্গ	u . l ɔ ŋ . ɡ ɔ
উল্কা	u l k ɐ
উল্কি	ˈu l k i
উষ্ণ	ˈu ʃ n o
উৎপত্তি	u t̪ p ɔ t̪ː i
ঋ	r iː
ঋতু	ɾ i t̪ u
এ	e
এ	æ
একজিবিশন	e k . d͡ʒ i . b i . ʃ ɔ n
একতা	æ . k ɔ . t̪ ɑ
এখন	æ kʰ ɔ n
এখনও	æ kʰ ɔ n o
এবও	ɛ . b ɔ
এবে	e . b e
এভাবে	e bʱ a b e
এভাবে	e v a b e
এলাকা	e l a k a
ঐ	o iː
ঐতিহাসিক	o i t̪ i ɦ ɑ s i k
ওঠা	ˈo ʈʰ a
ওদের	ˈɔː . ð ɛ ɹ
ওয়াক্ত	oʷ a k t̪
ওয়াক্ত	oʷ a k . t̪ o
ওয়াদা	w a d a
ওস্তাদ	o s t̪ a d̪
ঔ	o u
ক	k ɔ
কখন	k ɒ . kʰ ɒ n
কখনও	k ɔ kʰ ɔ n o
কঠিন	k ɔ ʈʰ i n
কত	ˈk ɔ t̪ o
কদম	k ɔ d ɔ m
কদাচিৎ	k ɔ . d̪ ɑ . t͡ʃ i t̪
কদু	k o d̪ u
কনকচাঁপা	k ɔ n ɔ k c ã p a
কন্ডম	ˈk ɔ n ɖ ɔ m
কফ	k ɔ pʰ
কবি	k ɔ . b i
কবুতর	k o b u t̪ ɔ r
কবে	k oː . b ɛ
কয়	k ɔ e̯
কয়ফল	k ɒ e̯ . ɸ ɒ l
কয়লাখনি	k ɔ e̯ . l ɑ . kʰ ɔ . n i
কয়েদ	k ɔ e̯ e d̪
কয়েদখানা	k ɔ e̯ e d̪ kʰ a n a
করঞ্জ	k ɔ ɾ ɔ n ɟ ɔ
করবী	k ɔ ɾ ɔ b i
করলা	k ɔ ɾ o l a
করা	k ɔ ɾ a
করা	k ɔ ɹ a
করা	k ɔ ɽ a
কলকাতা	ˈk o l ˌk a t̪ a
কলম	k ɔ l o m
কল্লা	k ɔ l . l a
কল্লা	k ɒ l . l a
কাঁঠাল	k a ʈʰ a l
কাঁসা	k ã s a
কাইল	k a i l
কাক	k a k
কাগজ	k a ɡ o d ʒ
কাগজ	k a ɡ o z
কাটা	k ɑ ʈ ɑ
কাটুয়া	k a . t̺ u a
কাঠিপোকা	k ɑ . ʈ̟ʰ i . p o . k ɑ
কাডোল	k a . d̺ ɔ l
কাণ্টা	k a n . t̺ a
কাণ্টামি	k a n . t̺ a . m i
কান	k ɑ n
কানুনগো	k ɑ . n u n . ɡ o
কান্দইন্যা	k a n . d̪ ɔ i n . n a
কান্দাইন্যা	k a n . d̪ a i n . n a
কাপড়	ˈk a p ɔ ɽ
কাপড়	ˈk a p ɔ ɹ
কামরাঙ্গা	k a m ɾ a ŋ ɡ a
কামুক	ˈk a m u k
কারখানা	k a r kʰ a n a
কারিগর	k a r i ɡ ɔ r
কারিগরি	k a r i ɡ o r i
কালা	k a . l a
কালো	k a l o
কাল্পনিক	k a l p o n i k
কাহই	k a . h ɔ i
কিংবা	k i ŋ b ɑ
কিচ্ছা	k i t ʃ t ʃʰ a
কিছু	k i t ʃʰ u
কিছু	k i s u
কিছুক্ষণ	k i t ʃʰ u kːʰ ɔ n
কিছুক্ষণ	k i s u kːʰ ɔ n
কিতা	k i . t̪ a
কিতাব	k i t a b
কিনইন্যা	k i . n ɔ i n . n a
কিনার	k i n a r
কিন্তু	k i n t̪ u
কিভাবে	k i bʱ a b e
কিভাবে	k i v a b e
কিশমিশ	k i ʃ m i ʃ
কীভাবে	k i bʱ a b e
কীভাবে	k i b a b e
কুকুর	k u k u ɾ
কুকুরছানা	k u k u ɾ t ʃʰ a n a
কুকুরছানা	k u k u ɽ t ʃʰ a n a
কুকুরছানা	k u k u ɽ s a n a
কুঞ্জলতা	k u n ɟ ɔ l ɔ t a
কুত্তা	k u t̪ː a
কুম	k u m
কুয়াশা	k u a . ʃ a
কুসুম	k u ʃ u m
কুস্তি	k u s t̪ i
কৃষ্ণচূড়া	k ɾ i ʃ n ɔ c u ɽ a
কৃষ্ণচূড়া	k ɾ i ʃ ʈ ɔ̃ c u ɽ a
কেগা	k e . ɡ a
কেঠা	k ɛ . t̺ʰ a
কেডা	k ɛ . d̺ a
কেন	k ɛ . n oː
কেয়া	k e a
কেলা	k ɛ . l a
কোমর	k ɔ m ɔ ɹ
কৌলিক	k o u̯ . l i k
কৌশিক	k o u . ʃ i k
কৌশিক	k o u̯ s̠ i k
কৌশিক	k o u̯ s̠ i k
ক্যা	k ɛ
ক্ষমাহীন	kʰ ɔ m a ɦ i n
কৎবেল	k ɔ t b e l
খ	kʱ ɔ
খয়ের	kʰ ɔ e ɾ
খরগোশ	ˈkʰ ɔ r ɡ o ʃ
খরচ	kʰ ɔ ɾ o t ʃ
খাতির	kʰ a t̪ i ɾ
খান	kʰ a n
খানকি	kʰ a ŋ k i
খারাপ	kʰ a ɾ a p
খালি	kʰ a l i
খালী	kʰ a l i
খুজুটিপাড়া	kʰ u . d͡ʒ u . ʈ̟ i . p ɑ . ɽ̟ ɑ
খুব	kʰ u b
খুশি	kʰ u ʃ i
খূব	kʰ u b
খেজুর	kʰ e d ʒ u r
খেয়াল	kʰ e a l
খেলনা	kʰ e l . n ɑ
খেলনা	kʰ ɛ l n ɑ
খেলনা	kʰ ɛ l n ɑ
খেলা	kʱ æ l a
খোঁজা	kʰ õ d ʒ a
খোঁজা	kʰ õ d z a
খোঁজা	kʰ õ z a
গ	ɡ ɔ
গং	ɡ ɔ ŋ
গণিকা	ɡ ɔ n i k a
গণ্ডার	ɡ ɔ n ɖ a r
গন্ডার	ɡ ɔ n ɖ ɑ ɾ
গন্ডার	ɡ ɔ n ɖ ɑ ɹ
গন্ধতৃণ	ɡ ɔ n dʱ ɔ t ɾ i n ɔ
গন্ধভাদাল	ɡ ɔ n dʱ ɔ bʱ a d a l
গরিলা	ɡ ɔ ɾ i l a
গরিলা	ɡ ɔ ɹ i l a
গর্দান	ɡ ɔ ɾ . d̪ a n
গলা	ɡ ɔ l a
গল্প	ɡ ɔ l p o
গহির	ɡ ɔ . ɦ i ɾ
গাঁইড়া	ɡ a i . ɾ a
গাঁজা	ˈɡ ã d ʒ a
গাঁজা	ˈɡ ã n d ʒ a
গাঁজা	ˈɡ a d ʒ a
গাঁজা	ˈɡ a n d ʒ a
গাঁজা	ˈɡ a d z a
গাঁজা	ˈɡ a n d z a
গাঁড়	ɡ ã ɽ
গাইড়া	ɡ a i . ɾ a
গাছ	ɡ ɑ s
গাছ	ɡ ɑ t ʃʰ
গাড়া	ɡ a ɽ a
গাড়ি	ɡ a ɽ i
গাড়ী	ɡ a ɽ i
গুজরাট	ɡ u d ʒ ɔ ɾ a ʈ
গুফা	ɡ u . pʰ ɑ
গুম	ɡ u m
গুম্ফা	ɡ u m . pʰ ɑ
গুরুত্বপূর্ণ	ɡ u r u tː ɔ p u r n ɔ
গুহা	ɡ u . ɦ ɑ
গেরাম	ɡ e . ɾ ɑ m
গোফা	ɡ o . pʰ ɑ
গোশ	ɡ o ʃ
গোশত	ɡ o ʃ t̪
গোশত	ɡ o ʃ t̪ o
গোস্ত	ɡ o s t̪ o
গৌতম	ɡ o u . t̪ ɔ m
গ্রন্থাগার	ɡ ɾ o n tʰ a ɡ a ɾ
গ্রাম	ɡ ɾ ɑ m
গ্রেপ্তার	ɡ ɾ e p t̪ a ɾ
গ্রেফতার	ɡ ɾ e f t̪ a ɾ
গ্লাস	ɡ l a s
গ্লাস	ɡ l a ʃ
ঘ	ɡʱ ɔ
ঘর	ɡʱ ɔ ɾ
ঘাড়	ɡʱ a ɽ
ঘুড়ি	ɡʱ u ɽ i
ঘুড়ি	ɡ u ɽ i
ঘোঙ্গা	ˈɡʱ o ŋ . ɡ ä
ঘোড়া	ɡʱ o ɽ a
ঘোষ	ɡʱ o ʃ
ঘোষাল	ɡʱ o . ʃ ɑ l
ঙ	ŋ ɔ
চ	t͡ʃ ɔ
চ	t͡s ɔ
চ	t͡ɕ ɔ
চউখ	t͡s ɔ u kʰ
চউখ	t͡s ɔ u k
চউখ	s ɔ u k
চর্বি	t ʃ o r b i
চশমা	t ʃ ɔ ʃ m a
চা	t ʃ a
চাউল	c a u̯ l
চাকমা	t͡ʃ ɐ k m ɐ
চাকা	t ʃ a k a
চাটা	ˈt ʃ a ʈ a
চান	t ʃ a n
চান	t͡s a n
চান	s a n
চানকপাইল্যা	t͡s a n . k ɒ . p a i l . l a
চানকপাইল্যা	t͡s a n . k ɒ . ɸ a i l . l a
চানকপাইল্যা	s a n . k ɒ . p a i l . l a
চানকপাইল্যা	s a n . k ɒ . ɸ a i l . l a
চান্নি	t͡s a n . n i
চান্নি	s a n . n i
চামচড়া	t͡s a m . t͡s ɒ . ɾ a
চামচড়া	s a m . s ɒ . ɾ a
চালতা	c a l t a
চালানো	ˈt ʃ a l a n o
চিংড়ি	t͡ʃ i ŋ r i
চিড়িয়াখানা	t ʃ i ɽ i a kʰ a n a
চিনি	t ʃ i n i
চিলমচি	t ʃ i l ɔ m t ʃ i
চুঁচি	ˈt͡ʃ ũ . t͡ʃ i
চুঁচি	ˈt͡s ũ . t͡s i
চুদা	t͡ʃ u . d̪ ɑ
চুম্বন	t ʃ u m b ɔ n
চুরট	t͡ʃ u . ɾ ɔ ʈ̟
চুরি	t͡ʃ u r i
চুরুট	t͡ʃ u . ɾ u ʈ̟
চুল	t ʃ u l
চুল	t s u l
চেত	t͡ʃ e t̪ o
চেত	t͡s ɛ t̪
চেত	s ɛ t̪
চেত	t͡s ɛ t̪
চেত	s ɛ t̪
চেতা	t͡ʃ e t̪ a
চেতা	t͡s ɛ t̪ a
চেতা	s ɛ t̪ a
চেতা	t͡s ɛ t̪ a
চেতা	s ɛ t̪ a
চেয়ার	ˈt͡ʃ e . ä ɾ
চেয়ে	ˈt͡ʃ e j e
চৈনিক	t͡ʃ o i̯ . n i k
চোখ	t ʃ o kʰ
চোথা	c o . t̪ʰ a
চোদা	t͡ʃ o . d̪ ɑ
চোষা	t ʃ o ʃ ɑ
চোষা	t s o ʃ ɑ
চৌধুরি	ˈt͡ʃ o u̯ . d̪ʱ u . ɾ i
চৌধুরি	ˈt͡s o u̯ . d̪ʱ u . ɾ i
ছ	t͡ʃʰ ɔ
ছ	t͡sʰ ɔ
ছ	t͡ɕʰ ɔ
ছবি	t ʃʰ o b i
ছাত্র	t ʃʰ a t̪ ɾ o
ছিটমহল	t ʃʰ i ʈ . m ɔ ɦ ɔ l
ছিপ	t͡ʃʰ i p
ছিপ	s i p
ছিপ	s i ɸ
ছিপ	s i p
ছিপ	s i ɸ
ছিপি	t͡ʃʰ i . p i
ছিপি	s i . p i
ছিপি	s i . ɸ i
ছিপি	s i . p i
ছিপি	s i . ɸ i
ছেলে	t ʃʰ e l e
ছেলে	s e l e
জ	d͡ʒ ɔ
জঙ	ɟ ɔ ŋ
জন্মদিন	ˈd ʒ ɔ n m o ˌd̪ i n
জন্যে	d ʒ ɔ nː e
জবাই	d ʒ ɔ b a i
জমি	d ʒ o m i
জমিন	d ʒ o m i n
জল	d͡ʒ ɔ l
জাড়	d ʒ a ɽ
জাড়	z a ɾ
জাড়	d͡z a ɾ
জাদু	d ʒ a d̪ u
জায়গা	d ʒ a e̯ ɡ a
জিগানো	z i . ɡ a . n ɔ
জিনিস	d ʒ i n i ʃ
জিব্ভা	z i b . bʱ a
জির্ভা	z i ɾ . bʱ a
জিহ্বা	d͡ʒ i u̯ bʱ a
জিহ্বা	d͡ʒ i u̯ β a
জীবন	d ʒ i b ɔ n
জীবিত	d͡ʒ i . b i . t̪ ɔ
জীবিত	d͡ʒ i b i t̪ o
জীবিত	d͡ʒ i b i t̪ o
জেঠ	z ɛ t̺ʰ
জোস	d ʒ o s
জোস	d ʒ o ʃ
জ্যোৎস্না	d ʒ o t ˈs n a
ঝ	d͡ʒʱ ɔ
ঝাল	ɟʱ a l
ঝিঙা	ɟʱ i ŋ a
ঝিঙ্গা	ɟʱ i ŋ ɡ a
ঞ	j ɔ̃
ঞ	n ɔ
ট	ʈ ɔ
টমটম	ʈ̟ ɔ m . ʈ̟ ɔ m
টলা	t̺ ɒ . l a
টানা	ˈʈ a n a
টিকট	ˈʈ̟ i . k ɔ ʈ̟
টিকিট	ˈʈ̟ i . k i ʈ̟
টুপি	ˈʈ u p i
টেলক	ʈ æ . l ɔ k
টেলক	t̺ ɛ . l ɔ k
টেলক	t̺ ɛ . l ɔ k
টেহা	t̺ ɛ . ɦ a
ট্যাক্সি	ʈ æ k s i
ঠ	ʈʱ ɔ
ঠাঁঁই	ʈʰ ã i
ঠাঁই	ʈʰ ã i
ঠোঁট	tʰ o t
ঠোঁট	tʰ u t
ড	ɖ ɔ
ডগ	d̺ ɒ ɡ
ড়	ɽ̟
ডাক্তার	ɖ a k t̪ a ɾ
ডাঙর	d a ŋ ɔ ɾ
ডিম	ɖ i m
ডিলডো	ɖ i l ɖ o
ডিল্ডো	ɖ i l ɖ o
ডুরিয়ান	ɖ̟ u . ɾ i . ɑ n
ডেহা	d̺ ɛ . ɦ a
ঢ	ɖʱ ɔ
ঢ়	ɽ̟
ঢাকা	ˈɖʱ a k a
ঢেঁড়স	ɖʱ æ̃ ɽ o ʃ
ণ	n ɔ
ত	t ɔ
তটিনী	t o ʈ i n i
তড়িৎ	ˈt̪ ɔ ɽ i t̪
তবু	t̪ ɔ b u
তবুও	t̪ ɔ b u o
তবে	t̪ ɔ b e
তল্লাশি	t̪ ɔ l l a ʃ i
তাঁরা	t̪ ã r a
তাং	t̪ a ŋ
তাই	t̪ a͡i
তাওয়া	t̪ a w a
তাকানো	t̪ a k a n̪ o
তাজ	t̪ a d ʒ
তাজা	t̪ a z a
তামা	t a m a
তামাশা	t̪ ä . m ä . s̠ ä
তামুক	t̪ a . m u k
তার	t̪ a r
তার	t̪ a r
তারা	t̪ a r a
তারা	t̪ a r a
তারিপ	t̪ ä . ɾ i p
তারিফ	t̪ ä . ɾ i pʰ
তালাশ	t̪ a l a ʃ
তিনি	t̪ ɪ . n̪ ɪ
তিমি	t̪ i m i
তিসি	t i ʃ i
তীর	t̪ ɪː ɾ
তুঁই	t̪ ũ i
তুই	ˈt̪ ʊ i
তুফান	t̪ u f a n
তুমি	ˈt̪ u ˌm i
তুরিত	ˈt̪ u . ɾ i t̪
তুলনামূলক	t u l n a m u l ɔ k
তৃণমূল	t̪ ɾ i . n ɔ . m u l
তেঁতুল	t ẽ t u l
তেল	t̪ e l
তোমাদের	ˈt̪ o m ɑ ˌd̪ ɛ ɹ
তোশক	t̪ o ʃ o k
ত্রিপত্র	t ɾ i p ɔ tː ɾ ɔ
থ	tʱ ɔ
থন	t̪ʰ ɒ n
থনে	t̪ʰ ɒ n e
থলি	t̪ʰ ɔ . l i
থাকা	t̪ʰ ɑ k ɑ
থানকুনি	tʰ a n k u n i
থার্মমিটার	t̪ʰ ɑ ɾ . m ɔ . m i . ʈ̟ ɑ ɾ
থার্মোমিটার	t̪ʰ ɑ ɾ . m o . m i . ʈ̟ ɑ ɾ
দ	d̪ ɔ
দইর্যা	d̪ ɔ i ɾ . d͡ʑ a
দইর্যা	d̪ ɔ i ɹ . ɹ a
দখল	d̪ ɔ kʰ o l
দপ্তর	d̪ ɔ p t̪ o ɾ
দফতর	d̪ ɔ f t̪ o ɾ
দফা	d̪ ɔ f a
দরবার	d̪ ɔ r b a r
দরিয়া	d̪ o r i j a
দলান	d̪ ɒ . l a n
দলিত	d̪ ɔ . l i t̪
দাঁড়ানো	d̪ a ɽ a n o
দাঁড়ানো	d̪ ã ɽ a n o
দাঁড়ানো	d̪ a ɾ a n o
দাঁড়ানো	d̪ a ɹ a n o
দাঁত	d̪ ɑ t̪
দাঁত	d̪ ɑ̃ t̪
দাউদাউ	d̪ a u̯ . d̪ a u̯
দাওয়াত	d̪ a w a t̪
দাখিল	d̪ a kʰ i l
দাড়ি	d a ɽ i
দালান	d̪ a . l a n
দীপঙ্কর	d̪ i . p ɔ ŋ . k ɔ ɾ
দীপান্বিতা	d̪ i . p ɑ n . n i . t̪ ɑ
দীপাবলি	d̪ i . p ɑ . b ɔ . l i
দীপাবলি	d̪ i p ä b o l i
দীপাবলি	d̪ i p ä b o l i
দীপোৎসব	d̪ i . p o t̪ . ʃ ɔ b
দুঃখ	d u k ˈkʰ o
দুইন্যাই	d u i n . n a i
দুইপর	d̪ u i . p ɒ ɾ
দুইপর	d̪ u i . ɸ ɒ ɾ
দুগি	d̪ u . ɡ i
দুপুর	d̪ u p u ɾ
দুরিয়ান	d̪ u . ɾ i . ɑ n
দেখা	ˈd̪ æ kʰ a
দেশ	d̪ e ʃ
দেশি	d̪ e ʃ i
দোতারা	d̪ o t̪ a ɾ a
দোলনা	d o l n a
দ্রুত	d̪ ɾ ʊ t̪ o
ধ	dʱ ɔ
ধন	d̪ʱ ɔ n
ধন	d̪ ɔ n
ধনিয়া	dʱ o n i a
ধনে	dʱ o n e
ধর্ষণ	dʱ ɔ ɾ . ʃ ɔ n
ধাইর	d̪ʱ a i ɾ
ধারি	d̪ʱ a . ɾ i
ধুতুরা	d̪ʱ u t̪ u ɾ ɑ
ধুতুরা	d̪ʱ u t̪ u ɽ ɑ
ন	n ɔ
নং	n ɔ ŋ
নউগল	n ɔ u . ɡ ɔ l
নকল	n ɔ k o l
নগ্ন	n ɔ ɡ n o
নগ্নতা	n ɔ ɡ n o t̪ a
নতুন	n ɔ t̪ u n
নবডঙ্কা	n ɔ . b ɔ . d ɔ ŋ . k ɑ
নববর্ষ	n ɔ . b ɔ . b ɔ ɾ . ʃ ɔ
নববর্ষ	n ɔ̜ b o b ɔ̜ ɾ s̠ o
নববর্ষ	n ɔ̜ b o b ɔ̜ ɾ s̠ o
নভেল	n ɔ . bʱ e l
নমস্কার	n ɔ m ɔ ʃ k a r
নমাজ	n ɔ m a z
নরম	n ɔ ɾ o m
নাইকল	n a i . k ɒ l
নাইহল	n a i . ɦ ɒ l
নাগেশ্বর	n a ɡ e ʃː ɔ ɾ
নাঙ্গা	n a ŋ a
নাঙ্গা	n a ŋ ɡ a
নাদান	n a d̪ a n
নাপ্পি	n ɑ p . p i
নাম	n a m
নামহীন	ˈn a m ɦ i n
নামাজ	n a m a z
নারাজ	n a r a z
নারাজ	n a r a d ʒ
নিমন্ত্রণ	n i m o n t̪ ɾ o n
নিয়াস	n i a ʃ
নিষিদ্ধ	n i ʃ i d̪ːʱ o
নীহারিকা	n i ɦ a ɾ i k a
নীহারিকা	n i ɦ a ɽ i k a
নুনি	n u . n i
নুনু	n u . n u
নেপিদ	n e . p i . d̪ ɔ
নেমন্তন্ন	n e m o n t̪ o n n o
ন্যূনতম	n u n . t̪ ɔ . m ɔ
প	p ɔ
পক্ষে	p ɔ kːʰ e
পছন্দ	p ɔ s o n d̪ o
পছন্দ	p ɔ t ʃʰ o n d̪ o
পটোল	p ɔ ʈ o l
পড়া	ˈp ɔ ɽ a
পড়া	ˈp ɔ ɹ a
পতর	p ɔ . t̪ ɔ ɾ
পতর	p ɒ . t̪ ɔ ɾ
পতর	ɸ ɒ . t̪ ɔ ɾ
পদ্ম	p ɔ d̪ː ɔ
পয়গম্বর	p ɔ e̯ . ɡ ɔ m . b ɔ ɾ
পর	p ɔ ɾ
পর	p ɒ ɾ
পর	ɸ ɒ ɾ
পরশু	p ɔ ɾ . ʃ u
পরা	ˈp ɔ r a
পরা	ˈp ɔ ɹ a
পরিস্থিতি	p ɔ . ɾ i ʃ . t̪ʰ i . t̪ i
পরু	p ɔ ɾ u
পরু	ɸ ɔ ɾ u
পরেন্দা	p ɔ . ɾ ɛ n . d̪ a
পর্ন	p ɔ ɹ n
পর্বত	p ɔ r b ɔ t
পসর	p ɒ . ʃ ɔ ɾ
পসর	ɸ ɒ . ʃ ɔ ɾ
পহর	p ɒ . ɦ ɔ ɾ
পহর	ɸ ɒ . ɦ ɔ ɾ
পা	p a
পাইথন	p ɑ i . t̪ʰ ɔ n
পাউরা	p a u . ɾ a
পাকস্থলী	p a k ɔ s tʰ o l i
পাখি	p a kʰ i
পাছা	p a t ʃʰ a
পাছা	p a s a
পাঠা	ˈp a ʈʰ a
পাঠানো	p ɑ ʈʰ ɑ n o
পাড়	p a ɾ
পাড়	ɸ a ɾ
পাতা	p a t a
পাত্তা	ˈp ä t̪ . t̪ äˑ
পানি	ˈp ɑː n iː
পানিয়ালা	p a n i a l a
পানু	p ɑ . n u
পান্থপাদপ	p a n tʰ ɔ p a d ɔ p
পান্না	p a nː a
পায়ু	p ɑ . e̯ u
পায়ুকাম	p ɑ . e̯ u . k ɑ m
পায়ুকামী	p ɑ . e̯ u . k ɑ . m i
পারদ	p ɑ . ɾ ɔ d̪
পারা	p a ɾ a
পারা	p a ɹ a
পারা	p a ɽ a
পার্থক্য	p a ɾ t̪ʰ ɔ kː o
পার্থক্য	p a ɹ t̪ʰ ɔ kː o
পাসরা	p a . ʃ ɔ . ɾ a
পাহাল	p a . ɦ a l
পাহাল	ɸ a . ɦ a l
পাহুরা	p a . ɦ u . ɾ a
পিতা	p i . t̪ aː
পিপলী	p i p ɔ l i
পিপ্পল	p i pː ɔ l
পিয়ানো	p i ɑ n o
পুজো	p u . d͡ʒ o
পুটকি	p u ʈ k i
পুড়ি	p u . ɾ i
পুড়ি	ɸ u . ɾ i
পুত	p u t̪
পুত	p u t̪
পুত	ɸ u t̪
পুদিনা	p u d̪ i n a
পুরস্কার	p u . ɾ ɔ ʃ . k ɑ ɾ
পুরস্কার	p u ɾ o s̠ k ä ɾ
পুরস্কার	p u ɾ o s̠ k ä ɾ
পুষ্টিকর	p u ʃ . ʈ̟ i . k ɔ ɾ
পুষ্প	p u ʃ p ɔ
পুস্তক	p u s t ɔ k
পূজা	p u . d͡ʒ ɑ
পূতিবাত	p u t i b a t
পেঁক	p ɛ k
পেঁক	ɸ ɛ k
পেঁচা	p ɛ̃ t ʃ a
পেখম	p e kʰ ɔ m
পেরেশান	p e r e ʃ a n
পোয়াত	p ɔ a t̪
পোয়াত	ɸ ɔ a t̪
প্যাঁচা	p ɛ̃ t ʃ a
প্রসব	p ɾ o ʃ ɔ b
প্রসাধন	p ɾ ɔ . ʃ ɑ . d̪ʱ ɔ n
প্রস্তুত	p ɾ ɔ ʃ . t̪ u t̪
প্রাচীন	p r ɑ c i n
প্রেমিক	p ɾ e . m i k
প্রেমিকা	p ɾ e . m i . k ɑ
প্লিজ	p l i z
প্লীজ	p l i z
ফ	pʰ ɔ
ফ	ɸ ɔ
ফ	f ɔ
ফড়িং	pʰ ɔ ɽ i ŋ
ফড়িং	f ɔ ɹ i ŋ
ফল	pʰ ɔ l
ফল	f ɔ l
ফলসা	pʰ ɔ l ʃ a
ফাটাফাটি	ˈf a ʈ a ˌf a ʈ i
ফায়দা	f a j d̪ a
ফারাক	f a r a k
ফিরেবার	ɸ i . ɾ e . b a ɾ
ফুটি	pʰ u ʈ i
ফুল	pʰ u l
ফুল	f u l
ফেলা	ˈpʰ ɛ l ɑ
ফেলা	ˈf ɛ l ɑ
ফ্লপি	pʰ l ɔ p i
ব	b ɔ
বকুল	b o k u l
বগল	b o ɡ o l
বঙ্গ	ˈb ɔ ŋ ɡ ɔ
বজ্র	b ɔ ɟ ɾ ɔ
বড়দিন	b ɔ . ɽ̟ ɔ . d i n
বড়োদিন	b ɔ . ɽ̟ o . d i n
বদলে	b ɔ d o l e
বন	b ɔ n
বন্ধুহীন	ˈb ɔ n d̪ʱ u ˌɦ i n
বন্ধুহীন	ˈb ɔ n d̪ u ˌɦ i n
বন্ধে	b ɒ n . d̪ʱ e
বন্যা	b ɔ nː a
বয়ঃসন্ধি	b ɔ . e̯ ɔ h . ʃ ɔ n . d̪ʱ i
বয়রা	b ɒ e̯ . ɾ a
বরফ	b ɔ r ɔ f
বরফ	b ɔ r ɔ pʰ
বলা	ˈb ɔ l a
বসা	ˈb ɔ ʃ a
বসু	b ɔ . ʃ u
বস্তু	ˈb ɔ s t̪ u
বহেড়া	b ɔ h e ɽ a
বা	b ɑ
বাঁচাও	b ã c a o
বাঁদর	b ã d̪ ɔ ɾ
বাঁদর	b ã d̪ ɔ ɹ
বাঁশি	b ã ʃ i
বাংলাদেশ	ˈb a ŋ l a ˌd̪ e ʃ
বাংলাদেশি	ˈb a ŋ l a ˌd̪ e ʃ i
বাংলাদেশী	ˈb a ŋ l a ˌd̪ e ʃ i
বাঃ	b aʱ
বাইট	b a i ʈ
বাইত্যা	b a i t̪ . t̪ a
বাইরা	b a i ɾ a
বাইরাগ	b a i . ɾ a ɡ
বাকি	b a k i
বাকী	b a k i
বাগ	b a ɡ
বাগান	b a ɡ a n
বাগিচা	b a ɡ i t ʃ a
বাঘ	b a ɡ
বাঘ	b a ɡʱ
বাঙালি	b a ŋ a l i
বাজ	b a z
বাজ	b a d ʒ
বাজ	b a d ʒ
বাজার	b a z a ɾ
বাজার	b a d ʒ a ɾ
বাত	b a t̪
বাত্তি	b a t̪ . t̪ i
বাদ	b a d̪
বাদশাহ	b a d̪ ʃ a ɦ
বাদুড়	b a d̪ u ɽ
বাদুড়	b a d̪ u ɹ
বান	b a n
বানর	b a n ɔ ɾ
বানর	b a n ɔ ɹ
বান্দর	b a n d̪ ɔ ɾ
বান্দর	b a n d̪ ɔ ɹ
বাবা	b a b a
বাবুর্চি	b a b u r t ʃ i
বারি	b a ɾ i
বাল	b a l
বালিশ	b a l i ʃ
বাহ	b aʱ
বাহির	b a ɦ i ɾ
বিচইন	b i . t͡s ɔ i n
বিচইন	b i . s ɔ i n
বিছনা	b i s . n a
বিজেপি	b i . d͡ʒ e . p i
বিজ্ঞান	b i ɡː æ n
বিজ্ঞাপন	b i ɡ j a p ɔ n
বিদেশ	b i d̪ e ʃ
বিদেশি	b i d̪ e ʃ i
বিদেশী	b i d̪ e ʃ i
বিনা	b i n a
বিন্দু	b i n d̪ u
বিবাদ	b i b ɑ d̪
বিভাগ	b i bʱ ɑ ɡ
বিভাগ	b i v ɑ ɡ
বিমানবন্দর	b i . m ɑ n . b ɔ n . d̪ ɔ ɾ
বিয়াল	b i a l
বিরুদ্ধে	b i r u d̪ːʱ e
বিলাই	b i . l a i
বিল্ব	b i lː ɔ
বিশেষজ্ঞ	b i . ʃ e . ʃ ɔ ɡ . ɡ ɔ
বিশেষজ্ঞ	b i s̠ e s̠ ɔ̜ ɡː õ
বিশেষজ্ঞ	b i s̠ e s̠ ɔ̜ ɡː õ
বিশ্বভারতী	b i ʃ . ʃ ɔ . bʱ ɑ . ɾ ɔ . t̪ i
বিশ্বভারতী	b i s̠ː o bʱ ä ɾ o t̪ i
বিশ্বভারতী	b i s̠ː o bʱ ä ɾ o t̪ i
বিশ্রী	b i s ɾ i
বিষ	b i ʃ
বিসর্গ	b i ʃ o r ɡ o
বীচি	ˈb i t ʃ i
বীচি	ˈb i t s i
বীচি	ˈb i s i
বুড়	b u ɾ
বুভুক্ষা	b u ˈbʱ u k . kʰ ɑ
বৃক্ষ	b r i k kʰ o
বেঁহা	b ɛ . ɦ a
বেকুব	b e k u b
বেগুন	b e ɡ u n
বেচইন্যা	b ɛ . t͡s ɔ i n . n a
বেচইন্যা	b ɛ . s ɔ i n . n a
বেডা	b ɛ . d̺ a
বেডি	b e . d̺ i
বেপরোয়া	b e p ɔ r w a
বেল	b e l
বেল	b e l
বেল	b e l
বেল	b e l
বেশী	b e ʃ i
বেশুমার	ˈb e . ʃ u . m ɑ ɾ
বৈঁচি	b õ ĩ̯ c i
বৈকঙ্কত	b o i̯ k ɔ ŋ k ɔ t
বোকা	b o k a
বোকাচোদা	ˈb o . k ɑ ˌt͡ʃ o . d̪ ɑ
বোঝা	b o d ʒʱ ɑ
বোঝা	b o d ʒ ɑ
বোঝা	b o z ɑ
বোন	b o n
বোরকা	b o ɾ k ɑ
বোরকা	b o ɹ k ɑ
বোস	b o ʃ
ব্যক্তি	b æ k t̪ i
ব্যস্ত	b ɛ s t̪ ɔ
ব্যাক	b ɛ k
ব্যাঘ্র	b æ ɡʱ ɾ ɔ
ব্যাটারি	b æ . ʈ̟ ɑ . ɾ i
ব্যাধি	b æ dʱ i
ব্লগ	b l ɔ ɡ
ব্ল্যাকহোল	ˈb l æ k . h o l
ব্ল্যাকহোল	ˈb l ɛ k . h o l
ভ	bʱ ɔ
ভগাঙ্কুর	bʱ ɔ . ɡ ɑ ŋ . k u ɾ
ভয়	bʱ ɔ e̯
ভাই	bʱ a j
ভাঙা	bʱ a ŋ a
ভাঙা	v a ŋ a
ভাজা	bʱ a j a
ভাড়াইট্যা	bʱ a . ɾ a i t̺ . t̺ a
ভাত	bʱ a t
ভারত	ˈbʱ a . ɾ ɔ t̪
ভাল	bʱ ɑ l o
ভাল	v ɑ l o
ভালভা	v a l v a
ভালা	bʱ a l a
ভালুক	bʱ a l u k
ভালুক	v a l u k
ভালো	bʱ a l o
ভালো	v a l o
ভালোবাসা	ˈbʱ a l o ˌb a ʃ a
ভাল্লুক	bʱ a lː u k
ভাল্লুক	v a lː u k
ভাষা	bʱ a ʂ aː
ভাষা	v ɑ ʃ ɑ
ভিয়েতনাম	v i j e t̪ n a m
ভিসি	bʱ i . ʃ i
ভুঁইচাল	bʱ u i . t͡s a l
ভুঁইচাল	bʱ u i . s a l
ভেড়া	bʱ e ɽ ɑ
ভেড়া	v e ɽ ɑ
ভেস্তা	bʱ e ʃ . t̪ ɑ
ভোদা	bʱ o d̪ a
ভোদা	b o d̪ a
ভোদা	v o d̪ a
ম	m ɔ
মই	m ɔ i
মত	ˈm ɔ t̪ o
মতি	m ɔ . t̪ i
মতো	ˈm ɔ t̪ o
মন্দ	m ɔ n . d̪ ɔ
মন্দ	m ɔ n . d̪ o
মন্দ	m ɔ n d̪
মন্দ	m ɔ n . d̪ ɔ
ময়ূর	m ɔ j u ɽ
ময়ূর	m ɔ j u ɾ
ময়ূর	m ɔ j u ɹ
ময়ূরী	m ɔ j u ɽ i
ময়ূরী	m ɔ j u ɾ i
ময়ূরী	m ɔ j u ɹ i
মরণ	m ɒ . ɹ ɒ n
মরা	ˈm ɔ ɾ a
মরা	ˈm ɔ ɹ a
মরিচ	m o ɾ i t ʃ
মলম	m ɔ l o m
মস্তিষ্ক	m ɔ s t̪ i ʃ k o
মহাভারত	m ɔ . ɦ ɑ . bʱ ɑ . ɾ ɔ t̪
মাইনষে	m a i n . ʃ e
মাকড়শা	m a k ɔ ɾ ʃ ɑ
মাকড়শা	m a k ɔ ɽ ʃ ɑ
মাকড়সা	m a k ɔ ɾ ʃ ɑ
মাকড়সা	m a k ɔ ɽ ʃ ɑ
মাখন	m ɑ kʰ ɔ n
মাছ	m ɑ t ʃʰ
মাছ	m ɑ s
মাছি	ˈm a t ʃʰ i
মাছি	ˈm a s i
মাত	m a t̪
মাতা	m a . t̪ a
মাতৃ	m ɑ t̪ . ɾ i
মাতৃভাষা	m ɑ t̪ . ɾ i . bʱ ɑ . ʃ ɑ
মাথা	m a t̪ʰ a
মাদান	m a . d̪ a n
মাধ্যমে	m a d̪ːʱ ɔ m e
মানষি	m a n . ʃ i
মানসিক	m ɑ . n ɔ . ʃ i k
মানু	m a . n u
মানুষ	m a n u ʃ
মাল	m ɑ l
মালূর	m a l u ɾ
মাশাআল্লাহ্	m a ʃ a . a l l aʱ
মিডা	m i . d̺ a
মিনসা	m i n . ʃ a
মু	m u
মুকেরি	ˈm u . k e . ɾ i
মুকেরি	ˈm u . k ɛ . ɾ i
মুক্তা	m u k t a
মুক্তিযুদ্ধ	m u k . t̪ i . d͡ʒ u d̪ . d̪ʱ ɔ
মুখ	m u kʰ
মুখ্যমন্ত্রী	m u k . kʰ ɔ . m ɔ n . t̪ ɾ i
মুখ্যমন্ত্রী	m u kːʰ o m o n t̪ ɾ i
মুখ্যমন্ত্রী	m u kːʰ o m o n t̪ ɾ i
মুত	m u t̪
মুতা	ˈm u . t̪ ä
মুরগি	m u r ɡ i
মুরগী	m u r ɡ i
মুরহা	m u ɾ . ɦ a
মুহাজির	m u h a j i r
মূত্র	ˈm u t̪ . t̪ ɾ ɔ̝ˑ
মূত্রনালি	ˈm u t̪ . t̪ ɾ ɔ̝ ˌn ä . l iˑ
মৃত	m ɾ i . t̪ ɔ
মৃত	m ɾ i t̪ o
মৃত	m ɾ i t̪ o
মৃত্যু	m r i t̪ t̪ u
মেকুর	ˈm ɛ . k u ɾ
মেঘ	m e ɡʱ
মেঘ	m ɛ ɡʱ
মেজাজ	m e d ʒ a d ʒ
মেথী	m e tʰ i
মেয়ে	ˈm e . e
মেয়েমানুষ	m ɛ ə . m ɜː . n ʊ ʃ
মেহুর	ˈm e . ɦ u ɾ
মোটা	ˈm o ʈ a
মোতি	m o . t̪ i
মোরগ	m o r ɔ ɡ
মৌচাক	m o u̯ t ʃ a k
মৌল	m o u̯ l
মৌসুম	m o u ʃ u m
মৌসুমি	m o u ʃ u m i
য	d͡ʒ ɔ
য়	j ɔ
য়	e ɔ
যিরূশালেম	d͡ʒ i ɾ u ʃ a l e m
যুবক	d ʒ u b ɔ k
যুবতী	d ʒ u b ɔ t̪ i
র	r ɔ
রইদ	r ɔ i d̪
রউন	r ɔ u n
রওনা	r ɔ o n a
রওয়ানা	r ɔ w a n a
রবীন্দ্রনাথ	ɾ ɔ . b i n . d̪ ɾ ɔ . n ɑ t̪ʰ
রবীন্দ্রনাথ	r o b i n d̪ ɾ o n ä t̪ʰ
রবীন্দ্রনাথ	r o b i n d̪ ɾ o n ä t̪ʰ
রসায়ন	ɹ o ɹ ʃ j n
রসুই	ɾ ɔ . ʃ u i
রসুইঘর	ɾ ɔ . ʃ u i . ɡʱ ɔ ɾ
রসুল	ɾ ɔ . ʃ u l
রাং	ɾ a ŋ
রাই	ɾ a i
রাইত	ɾ a i t̪
রাজি	r a z i
রাজি	r a d ʒ i
রামায়ণ	ɾ ɑ . m ɑ . e̯ ɔ n
রাষ্ট্র	ɾ a ʃ . ʈ ɾ ɔ
রাস্তা	ɾ a s t̪ a
রাহুল	ɾ ɑ . ɦ u l
রিকশা	r i k . ʃ ɑ
রিশকা	r i ʃ . k ɑ
রিষ্ট	ɾ i ʃ ʈ ɔ
রীতি	ɾ i t̪ i
রীতি	ɽ i t̪ i
রোগ	ɾ o ɡ
রোজা	ɾ o z a
রোহিত	ɾ o . ɦ i t̪
ল	l ɔ
লক্ষ্মীপেঁচা	l o kːʰ i p æ̃ c a
লক্ষ্মীফল	l o kːʰ i pʰ ɔ l
লড়া	l ɔ ɹ a
লড়া	l ɔ ɽ a
লবডঙ্কা	l ɔ . b ɔ . d ɔ ŋ . k ɑ
লবণ	l ɔ b o n
লাইব্রেরী	l a i b ɾ e ɾ i
লাউ	l a u
লাও	l a o
লাকান	l a . k a n
লাখ	l ɑː kʰ
লাভ	l a bʱ
লালা	ˈl a l a
লাশ	l a ʃ
লাহান	l a . ɦ a n
লিচু	l i . t ʃ u
লুডা	l u . d̺ a
লেবু	ˈl e b u
শ	ʃ ɔ
শ	s ɔ
শউর	ʃ ɔ u ɾ
শউরী	ʃ ɔ u . ɾ i
শক্ত	ʃ ɔ k t̪ ɔ
শঙ্খচূড়	ˈʃ ɔ ŋ kʰ o ˌt ʃ u ɽ
শজারু	ʃ ɔ . d͡ʒ a . r u
শত	ʃ ɔ . t̪ ɔ
শতরকম	ʃ ɔ . t̪ ɔ . ɾ ɔ . k ɔ m
শতাংশ	ʃ ɔ . t̪ ɑ ŋ . ʃ ɔ
শয়তান	ʃ ɔ j t̪ a n
শরাব	s h ô r a b
শল্যচিকিৎসা	ʃ ɔ l . l ɔ . t͡ʃ i . k i t̪ . ʃ ɑ
শল্যচিকিৎসা	s̠ o lː o t͡ʃ i k i t̪ s̠ ä
শল্যচিকিৎসা	s̠ o lː o t͡ʃ i k i t̪ s̠ ä
শহর	ʃ ɔ ɦ ɔ ɾ
শহর	ʃ ɔ ɦ ɔ ɽ
শাণ্ডিল্য	ʃ a n ɖ i lː ɔ
শান্তনু	ʃ ɑ n . t̪ ɔ . n u
শান্তিনিকেতন	ʃ ɑ n . t̪ i . n i . k e . t̪ ɔ n
শাবাশ	ʃ a b a ʃ
শামিয়ানা	ʃ a m i j a n a
শামুক	ʃ a m u k
শালগম	ʃ a l ɡ ɔ m
শিকার	ʃ i k a r
শিকারি	ʃ i k a r i
শিক্ষক	ʃ i k . kʰ ɔ k
শিক্ষা	ʃ i kːʰ ɑ
শিক্ষামূলক	ʃ i kːʰ a m u l ɔ k
শিখ	ʃ i kʰ
শিথান	ʃ i . t̪ʰ a n
শিবদ্রুম	ʃ i b d r u m
শিরীষ	ʃ i ɾ i ʃ
শিশির	ʃ i . ʃ i ɾ
শুমার	ˈʃ u . m ɑ ɾ
শুরু	ˈʃ u . r u
শুলফা	ʃ u l pʰ a
শেখা	ʃ e kʰ a
শৈবাল	ʃ o i̯ b a l
শৈলুষ	ʃ o i̯ l u ʃ
শোনা	ʃ o n ɑ
শ্মশান	ʃ o ʃ ɐ n
শ্মশ্রু	ʃ w ɔ ʃ ɾ u
শ্মশ্রু	ʃ õ s ʃ ɾ u
শ্যাম্পু	ʃ æ m . p u
শ্রীনিকেতন	ʃ ɾ i . n i . k e . t̪ ɔ n
শ্রীফল	s ɾ i pʰ ɔ l
শ্রীবৃক্ষ	s ɾ i b ɾ i kːʰ ɔ
শ্লেষ্মা	ʃ l e ʃ . ʃ ɑ̃
ষ	ʃ ɔ
স	ʃ ɔ
স	s ɔ
সংক্রামক	ʃ ɔ ŋ k ɾ a m ɔ k
সংবাদ	ʃ ɔ ŋ b ɑ d̪
সংশয়	ʃ ɔ ŋ . ʃ ɔ e̯
সংস্কৃতি	ʃ ɔ ŋ ʃ . k ɾ i . t̪ i
সঙ্গে	ˈʃ ɔ ŋ ɡ e
সজারু	ʃ ɔ . d͡ʒ a . r u
সত্য	ʃ o tː ɔ
সত্যফল	ʃ o tː ɔ pʰ ɔ l
সদর	ʃ ɔ d̪ o ɾ
সদরদপ্তর	ʃ ɔ d̪ o ɾ d̪ ɔ f t o ɾ
সদরদফতর	ʃ ɔ d̪ o ɾ d̪ ɔ f t o ɾ
সদাই	ʃ ɔ d̪ a i
সনদ	ʃ ɔ n o d̪
সনদপত্র	ʃ ɔ n o d̪ p ɔ t̪ ɾ o
সপ্তাহ	ʃ ɔ p . t̪ ɑ . ɦ ɔ
সফর	s ɔ f o r
সফর	ʃ ɔ pʰ o r
সবজি	ʃ ɔ b d ʒ i
সবজি	ʃ ɔ b z i
সমক	ʃ ɒ . m ɔ k
সমকামিতা	s ɔ m ɔ k a m i t̪ a
সমকামিতা	ʃ ɔ m ɔ k a m i t̪ a
সমকামী	ʃ ɔ . m ɔ . k ɑ . m i
সমকে	ʃ ɒ m . k e
সময়কাল	ʃ ɔ m ɔ j k a l
সমাইন্যা	ʃ ɒ . m a i n . n a
সমীরণ	ʃ o m i ɾ ɔ n
সম্পাদক	ʃ ɔ m . p ɑ . d̪ ɔ k
সম্পাদিকা	ʃ ɔ m . p ɑ . d̪ i . k ɑ
সরকার	ʃ ɔ ɾ k a ɾ
সরদ	ʃ ɔ . ɾ ɔ d̪
সলিল	ʃ o l i l
সহকর্মী	ʃ ɔ . ɦ ɔ . k ɔ ɾ . m i
সহযোগিতা	ʃ ɔ . ɦ ɔ . d͡ʒ o . ɡ i . t̪ ɑ
সাঁকো	ʃ ã . k o
সাং	ʃ a ŋ
সাগর	ʃ a ɡ ɔ ɾ
সাদা	ʃ a d̪ a
সাপ	ʃ ɑ p
সাফ	s a pʰ
সাফ	s a f
সাবান	ʃ a b a n
সাবাশ	ʃ a b a ʃ
সাবাস	ʃ a b a ʃ
সার	ʃ a ɾ
সার্জারি	ʃ ɑ ɾ . d͡ʒ ɑ . ɾ i
সালাম	s a l a m
সালোকসংশ্লেষ	ʃ ɑ . l o k . ʃ ɔ ŋ . ʃ l e ʃ
সালোকসংশ্লেষণ	ʃ ɑ . l o k . ʃ ɔ ŋ . ʃ l e . ʃ ɔ n
সিগারেট	s i ɡ ɑ r e ʈ
সিন্দুক	ʃ i n d̪ u k
সিন্ধু	ʃ i n d̪ʱ u
সিন্ধু	ʃ i n d̪ u
সিন্ধুঘোটক	ʃ i n d̪ʱ u ɡʱ o ʈ ɔ k
সিন্ধুঘোটক	ʃ i n d̪ u ɡ o ʈ ɔ k
সিলডি	s i . l ɔ . d̺ i
সিলেইট্যা	s i . l e i t̺ . t̺ a
সুইজারল্যান্ড	ʃ u i . d͡ʒ ɑ ɾ . l æ n ɖ̟
সুকুমার	ʃ u . k u . m ɑ ɾ
সুগার	ʃ u . ɡ ɑ ɾ
সুজিত	ʃ u . d͡ʒ i t̪
সুন্দর	ʃ u n d̪ ɔ ɾ
সুন্দরী	ʃ u n d̪ ɔ ɾ i
সুভদ্রক	ʃ u bʱ ɔ dː ɾ ɔ k
সুরত	s u r ô t
সুলতান	s u l t̪ a n
সুলতানা	s u l t̪ a n a
সে	ˈʃ e
সেঁউতি	ʃ ẽ u . t̪ i
সেঁজার	ʃ ɛ . z a ɾ
সেঁজার	ʃ ɛ̃ . d͡z a ɾ
সেজার	ʃ ɛ . z a ɾ
সেজার	ʃ ɛ . d͡ʑ a ɾ
সেন্সস	ˈʃ e n . ʃ ɔ ʃ
সেন্সস	ˈʃ ɛ n . ʃ ɔ ʃ
সোহম	ʃ o . ɦ ɔ m
সোহম	s̠ o ɦ o m
সোহম	s̠ o ɦ o m
সৌন্দর্য	ʃ o u n d̪ ɔ ɾ d ʒ o
সৌন্দর্য	s o u n d̪ ɔ ɾ d ʒ o
সৌন্দর্য	ʃ o u n d̪ ɔ ɹ d ʒ o
সৌন্দর্য	s o u n d̪ ɔ ɹ d ʒ o
সৌন্দর্য	ʃ o u n d̪ ɔ ɹ z o
সৌন্দর্য	s o u n d̪ ɔ ɹ z o
স্কুটার	ʃ k u . ʈ̟ ɑ ɾ
স্তালিন	ʃ t̪ ɑ . l i n
স্নেহ	ˈs n e ɦ o
স্ফটিক	ʃ pʰ o ʈ i k
স্বপন	ʃ ɔ p o n
স্বপ্ন	ʃ ɔ p n o
স্বাধীনতা	ʃ ɑ . dʱ i . n ɔ . t̪ ɑ
স্বাস্থ্য	ʃ a s tʰ j ɔ
স্রেফ	s ɾ e f
সৎ	ˈs ɔ t̪
হ	h ɔ
হউর	ɦ ɔ u ɾ
হউরী	ɦ ɔ u . ɾ i
হক্কল	ɦ ɒ k . k ɔ l
হগল	ɦ ɒ . ɡ ɔ l
হঙ্গে	ɦ ɒ ŋ . ɡ e
হঠাত্	ɦ ɔ ʈʰ a t̪
হতাশা	ɦ ɔ t̪ ɑ ʃ ɑ
হন্দর	ɦ ɔ n . d̪ ɔ ɾ
হপন	ɦ ɒ . p ɔ n
হপন	ɦ ɒ . ɸ ɔ n
হমকে	ɦ ɒ m . k e
হমাইন্যা	ɦ ɒ . m a i n . n a
হমান	ɦ ɒ . m a n
হমুক	ɦ ɔ . m u k
হয়রান	ɦ ɔ e̯ ɾ a n
হরা	ɦ ɒ . ɾ a
হরিজন	ɦ ɔ . ɾ i . d͡ʒ ɔ n
হরিদ্বার	ɦ ɔ . ɾ i d̪ . d̪ ɑ ɾ
হরিদ্বার	ɦ o ɾ i d̪ː ɑ ɾ
হরিদ্বার	ɦ o ɾ i d̪ː ɑ ɾ
হরীতকী	h o ɾ i t o k i
হরু	ɦ ɔ . ɾ u
হরুলা	ɦ ɔ . ɾ u . l a
হহুন	ɦ ɔ . ɦ u n
হাঁ	h æ̃ː
হাঁই	ɦ a i
হাঁচোর	ɦ a t͡s o ɾ
হাঁচোর	ɦ a t͡s u ɾ
হাঁচোর	ɦ a s u ɾ
হাঁচোর	ɦ ã s u ɾ
হাঁটা	ˈɦ a ʈ a
হাঁটু	ˈɦ a ʈ u
হাঁটু	ˈɦ ã ʈ u
হাঁতরানো	ɦ a t̪ . ɾ a . n ɔ
হাঁতার	ɦ a t̪ a ɾ
হাইর	ɦ a i ɾ
হাওন	ɦ a o n
হাগা	ˈɦ a ɡ a
হাগু	ˈɦ a ɡ u
হাঙ্গুর	h ɐ ŋ ɡ u r
হাচা	ɦ a . t͡s a
হাচা	ɦ a . s a
হাড়ি	ɦ a . ɾ i
হাত	ɦ a t̪
হাতি	ɦ ɑ t̪ i
হাপ	ɦ a p
হাপ	ɦ a ɸ
হাবশি	ˈɦ ɑ b . ʃ i
হামলা	ɦ a m . l a
হামানদিস্তা	h a m a n d i s t a
হামানো	ɦ a . m a . n ɔ
হামুক	ɦ a . m u k
হাসা	ɦ ɑ ʃ ɑ
হাসানো	ɦ ɑ ʃ ɑ n o
হিংসা	ɦ i ŋ ʃ a
হিগা	ɦ i . ɡ a
হিজড়া	ˈɦ i d ʒ ɽ a
হিজড়া	ˈɦ i d ʒ ɹ a
হিটলার	ɦ i ʈ̟ . l ɑ ɾ
হিডা	ɦ i . d̺ a
হিনান	ɦ i . n a n
হিনি	ɦ i . n i
হিম	ɦ i m
হিমাচল	ɦ i . m ɑ . t͡ʃ ɔ l
হিমাচল	ɦ i m ä t͡ʃ ɔ̜ l
হিমাচল	ɦ i m ä t͡ʃ ɔ̜ l
হিমালয়	ɦ i . m ɑ . l ɔ e̯
হিয়ান	ɦ i a n
হিয়াল	ɦ i a l
হিল	ɦ i l
হিসাব	ɦ i ʃ a b
হিস্সা	ɦ i ʃ ʃ a
হুটকি	ɦ u t̺ . k i
হুদা	h u d ɐ
হুনা	ɦ u . n a
হুনি	ɦ u . n i
হুরইন	ɦ u . ɾ ɔ i n
হুরু	ɦ u . ɾ u
হুরুতা	ɦ u . ɾ u . t̪ a
হে	ɦ e
হেঁজ	ɦ ɛ z
হেঁজা	ɦ ɛ . z a
হেঁজার	ɦ ɛ . z a ɾ
হেই	ɦ e i
হেইতে	ɦ e i . t̪ e
হেউত	ɦ e u t̪
হেতাই	ɦ ɛ . t̪ a i
হেতাইন	ɦ ɛ . t̪ a i n
হেতি	ɦ e . t̪ i
হেতে	ɦ ɛ . t̪ e
হোয়া	ɦ ɔ a
হোয়াদ	ɦ o a d̪
হোল	ɦ o l
হ্যাঁ	h ɛ̃
া	aː
ি	i
ী	iː
ু	u
ূ	uː
ৃ	r iː
ৄ	ɽ iː
ে	e
ে	æ
ৈ	o iː
ো	o
ো	ʊ
ৌ	o uː
ৠ	ɽ iː
ৡ	ɭ iː
ৢ	l iː
ৣ	ɭ iː
ৰ	ɹ ɔ
