ripens	ripened	r2p@nz	r2p@nd
censors	censored	sEns@z	sEns@d
decorates	decorated	dEk@r1ts	dEk@r1tId
bluff	bluffed	blVf	blVft
mishears	misheard	"mIsh7z	"mIsh3d
grovels	grovelled	grQvPz	grQvPd
shivers	shivered	SIv@z	SIv@d
slaps	slapped	sl{ps	sl{pt
shiver	shivered	SIv@R	SIv@d
stupefy	stupefied	stjupIf2	stjupIf2d
ransom	ransomed	r{ns@m	r{ns@md
relishes	relished	rElISIz	rElISt
wanton	wantoned	wQnt@n	wQnt@nd
abash	abashed	@b{S	@b{St
miaow	miaowed	mi6	mi6d
cense	censed	sEns	sEnst
resolves	resolved	rIzQlvz	rIzQlvd
desists	desisted	dIzIsts	dIzIstId
wins	won	wInz	wVn
miss	missed	mIs	mIst
mock	mocked	mQk	mQkt
wear	wore	w8R	w$R
stabilize	stabilized	st1b@l2z	st1b@l2zd
wantons	wantoned	wQnt@nz	wQnt@nd
exists	existed	IgzIsts	IgzIstId
distract	distracted	dIstr{kt	dIstr{ktId
face	faced	f1s	f1st
fulls	fulled	fUlz	fUld
overdraws	overdrew	"5v@dr$z	"5v@dru
cross-pollinate	cross-pollinated	"krQspQl@n1t	"krQspQl@n1tId
swim	swum	swIm	swVm
reason	reasoned	rizH	rizHd
estimates	estimated	EstIm1ts	EstIm1tId
slander	slandered	sl#nd@R	sl#nd@d
seize	seized	siz	sizd
invades	invaded	Inv1dz	Inv1dId
fawns	fawned	f$nz	f$nd
comforts	comforted	kVmf@ts	kVmf@tId
dilapidates	dilapidated	dIl{pId1ts	dIl{pId1tId
walks	walked	w$ks	w$kt
comfort	comforted	kVmf@t	kVmf@tId
flute	fluted	flut	flutId
screen	screened	skrin	skrind
provide	provided	pr@v2d	pr@v2dId
bears	bore	b8z	b$R
pitches	pitched	pIJIz	pIJt
wedge	wedged	wE_	wE_d
cognizes	cognized	kQgn2zIz	kQgn2zd
deters	deterred	dIt3z	dIt3d
spanks	spanked	sp{Nks	sp{Nkt
anglicize	anglicized	{NglIs2z	{NglIs2zd
glazes	glazed	gl1zIz	gl1zd
ensures	ensured	InS$z	InS$d
scribbles	scribbled	skrIbPz	skrIbPd
react	reacted	rI{kt	rI{ktId
overcrop	overcropped	"5v@krQp	"5v@krQpt
overcrops	overcropped	"5v@krQps	"5v@krQpt
bedecks	bedecked	bIdEks	bIdEkt
oversleeps	overslept	"5v@slips	"5v@slEpt
exist	existed	IgzIst	IgzIstId
regulates	regulated	rEgjUl1ts	rEgjUl1tId
prostitutes	prostituted	prQstItjuts	prQstItjutId
abashes	abashed	@b{SIz	@b{St
pockets	pocketed	pQkIts	pQkItId
seizes	seized	sizIz	sizd
deceive	deceived	dIsiv	dIsivd
adores	adored	@d$z	@d$d
straiten	straitened	str1tH	str1tHd
sparks	sparked	sp#ks	sp#kt
wavers	wavered	w1v@z	w1v@d
sellotapes	sellotaped	sEl5t1ps	sEl5t1pt
weakens	weakened	wik@nz	wik@nd
persuade	persuaded	p@sw1d	p@sw1dId
lofts	lofted	lQfts	lQftId
steadies	steadied	stEdIz	stEdId
speculates	speculated	spEkjUl1ts	spEkjUl1tId
cruises	cruised	kruzIz	kruzd
ignores	ignored	Ign$z	Ign$d
trail	trailed	tr1l	tr1ld
strengthens	strengthened	strENTHz	strENTHd
peppers	peppered	pEp@z	pEp@d
crap	crapped	kr{p	kr{pt
slumber	slumbered	slVmb@R	slVmb@d
dispatch	dispatched	dIsp{J	dIsp{Jt
wash	washed	wQS	wQSt
float	floated	fl5t	fl5tId
halts	halted	h$lts	h$ltId
craps	crapped	kr{ps	kr{pt
assess	assessed	@sEs	@sEst
floats	floated	fl5ts	fl5tId
drifts	drifted	drIfts	drIftId
insults	insulted	InsVlts	InsVltId
activates	activated	{ktIv1ts	{ktIv1tId
buggers	buggered	bVg@z	bVg@d
grade	graded	gr1d	gr1dId
brawl	brawled	br$l	br$ld
unbends	unbent	"VnbEndz	"VnbEnt
bodes	boded	b5dz	b5dId
anglicizes	anglicized	{NglIs2zIz	{NglIs2zd
hits	hit	hIts	hIt
enacts	enacted	In{kts	In{ktId
deter	deterred	dIt3R	dIt3d
cognize	cognized	kQgn2z	kQgn2zd
peeps	peeped	pips	pipt
enlivens	enlivened	Inl2vHz	Inl2vHd
sheds	shed	SEdz	SEd
dimple	dimpled	dImpP	dImpPd
gesticulate	gesticulated	_EstIkjUl1t	_EstIkjUl1tId
reappears	reappeared	"ri@p7z	"ri@p7d
reasons	reasoned	rizHz	rizHd
overdraw	overdrew	"5v@dr$	"5v@dru
trails	trailed	tr1lz	tr1ld
weaken	weakened	wik@n	wik@nd
outvies	outvied	"6tv2z	"6tv2d
abounds	abounded	@b6ndz	@b6ndId
mocks	mocked	mQks	mQkt
spook	spooked	spuk	spukt
resolve	resolved	rIzQlv	rIzQlvd
grades	graded	gr1dz	gr1dId
lectures	lectured	lEkJ@z	lEkJ@d
repay	repaid	rip1	rip1d
harry	harried	h{rI	h{rId
humidify	humidified	hjumIdIf2	hjumIdIf2d
receives	received	rIsivz	rIsivd
spare	spared	sp8R	sp8d
peep	peeped	pip	pipt
scribble	scribbled	skrIbP	skrIbPd
urges	urged	3_Iz	3_d
withholds	withheld	wIDh5ldz	wIDhEld
perish	perished	pErIS	pErISt
surmounts	surmounted	s3m6nts	s3m6ntId
smells	smelt	smElz	smElt
win	won	wIn	wVn
disconcert	disconcerted	"dIsk@ns3t	"dIsk@ns3tId
twists	twisted	twIsts	twIstId
banter	bantered	b{nt@R	b{nt@d
substitute	substituted	sVbstItjut	sVbstItjutId
conglomerate	conglomerated	k@nglQm@r1t	k@nglQm@r1tId
metricate	metricated	mEtrI"k1t	mEtrI"k1tId
slumps	slumped	slVmps	slVmpt
vends	vended	vEndz	vEndId
blow-dries	blow-dried	bl5dr2z	bl5dr2d
add	added	{d	{dId
cross-fertilize	cross-fertilized	"krQsf3t@l2z	"krQsf3t@l2zd
estimate	estimated	EstIm1t	EstIm1tId
dodders	doddered	dQd@z	dQd@d
shag	shagged	S{g	S{gd
parries	parried	p{rIz	p{rId
splits	split	splIts	splIt
spanks	spanked	sp{Nks	sp{Nkt
swoops	swooped	swups	swupt
commune	communed	k@mjun	k@mjund
calculates	calculated	k{lkjUl1ts	k{lkjUl1tId
headlines	headlined	hEdl2nz	hEdl2nd
casts	cast	k#sts	k#st
earns	earned	3nz	3nd
elect	elected	IlEkt	IlEktId
devises	devised	dIv2zIz	dIv2zd
dazes	dazed	d1zIz	d1zd
miscalls	miscalled	"mIsk$lz	"mIsk$ld
exonerates	exonerated	IgzQn@r1ts	IgzQn@r1tId
pocket	pocketed	pQkIt	pQkItId
swims	swum	swImz	swVm
derail	derailed	dIr1l	dIr1ld
cruise	cruised	kruz	kruzd
prods	prodded	prQdz	prQdId
itinerate	itinerated	ItIn@r1t	ItIn@r1tId
devise	devised	dIv2z	dIv2zd
set	set	sEt	sEt
communes	communed	k@mjunz	k@mjund
humidifies	humidified	hjumIdIf2z	hjumIdIf2d
captivate	captivated	k{ptIv1t	k{ptIv1tId
vocalize	vocalized	v5k@l2z	v5k@l2zd
calculate	calculated	k{lkjUl1t	k{lkjUl1tId
coddle	coddled	kQdP	kQdPd
charge	charged	J#_	J#_d
surmount	surmounted	s3m6nt	s3m6ntId
promise	promised	prQmIs	prQmIst
exposes	exposed	Iksp5zIz	Iksp5zd
guarantees	guaranteed	"g{r@ntiz	"g{r@ntid
notarize	notarized	n5t@r2z	n5t@r2zd
amortize	amortized	@m$t2z	@m$t2zd
crisps	crisped	krIsps	krIspt
twist	twisted	twIst	twIstId
lasts	lasted	l#sts	l#stId
garbs	garbed	g#bz	g#bd
shags	shagged	S{gz	S{gd
garb	garbed	g#b	g#bd
entrance	entranced	Intr#ns	Intr#nst
suppress	suppressed	s@prEs	s@prEst
spark	sparked	sp#k	sp#kt
metal	metalled	mEtP	mEtPd
cross-pollinates	cross-pollinated	"krQspQl@n1ts	"krQspQl@n1tId
propagandizes	propagandized	"prQp@g{nd2zIz	"prQp@g{nd2zd
censes	censed	sEnsIz	sEnst
sends	sent	sEndz	sEnt
amortizes	amortized	@m$t2zIz	@m$t2zd
walls	walled	w$lz	w$ld
wall	walled	w$l	w$ld
regress	regressed	rIgrEs	rIgrEst
waver	wavered	w1v@R	w1v@d
transmutes	transmuted	tr{nzmjuts	tr{nzmjutId
prongs	pronged	prQNz	prQNd
retaliate	retaliated	rIt{lI1t	rIt{lI1tId
adore	adored	@d$R	@d$d
desist	desisted	dIzIst	dIzIstId
snitch	snitched	snIJ	snIJt
snitches	snitched	snIJIz	snIJt
deny	denied	dIn2	dIn2d
denies	denied	dIn2z	dIn2d
scars	scarred	sk#z	sk#d
encapsulate	encapsulated	Ink{psjUl1t	Ink{psjUl1tId
reorientate	reorientated	"ri$rIEnt1t	"ri$rIEnt1tId
sacks	sacked	s{ks	s{kt
sue	sued	su	sud
bristle	bristled	brIsP	brIsPd
promises	promised	prQmIsIz	prQmIst
consubstantiate	consubstantiated	"kQns@bst{nSI1t	"kQns@bst{nSI1tId
elects	elected	IlEkts	IlEktId
purge	purged	p3_	p3_d
adds	added	{dz	{dId
negates	negated	nIg1ts	nIg1tId
assay	assayed	@s1	@s1d
restores	restored	rIst$z	rIst$d
savvies	savvied	s{vIz	s{vId
emphasize	emphasized	Emf@s2z	Emf@s2zd
yacht	yachted	jQt	jQtId
reverses	reversed	rIv3sIz	rIv3st
probes	probed	pr5bz	pr5bd
derails	derailed	dIr1lz	dIr1ld
urge	urged	3_	3_d
rubs	rubbed	rVbz	rVbd
traipses	traipsed	tr1psIz	tr1pst
circulate	circulated	s3kjUl1t	s3kjUl1tId
smell	smelt	smEl	smElt
tiptoe	tiptoed	tIpt5	tIpt5d
deliquesce	deliquesced	"dElIkwEs	"dElIkwEst
stabilizes	stabilized	st1b@l2zIz	st1b@l2zd
demobilizes	demobilized	dim5bIl2zIz	dim5bIl2zd
barbarize	barbarized	b#b@r2z	b#b@r2zd
hexes	hexed	hEksIz	hEkst
belt	belted	bElt	bEltId
straitens	straitened	str1tHz	str1tHd
conflates	conflated	k@nfl1ts	k@nfl1tId
reverse	reversed	rIv3s	rIv3st
guarantee	guaranteed	"g{r@nti	"g{r@ntid
deranges	deranged	dIr1n_Iz	dIr1n_d
scrub	scrubbed	skrVb	skrVbd
notarizes	notarized	n5t@r2zIz	n5t@r2zd
spank	spanked	sp{Nk	sp{Nkt
withers	withered	wID@z	wID@d
regresses	regressed	rIgrEsIz	rIgrEst
demobilizes	demobilized	dim5bIl2zIz	dim5bIl2zd
demonetizes	demonetized	"dimVnIt2zIz	"dimVnIt2zd
compels	compelled	k@mpElz	k@mpEld
restricts	restricted	rIstrIkts	rIstrIktId
tasks	tasked	t#sks	t#skt
humble	humbled	hVmbP	hVmbPd
curl	curled	k3l	k3ld
dance	danced	d#ns	d#nst
stupefies	stupefied	stjupIf2z	stjupIf2d
diminishes	diminished	dImInISIz	dImInISt
wears	wore	w8z	w$R
soil	soiled	s4l	s4ld
calve	calved	k#v	k#vd
investigates	investigated	InvEstIg1ts	InvEstIg1tId
tiptoes	tiptoed	tIpt5z	tIpt5d
scrubs	scrubbed	skrVbz	skrVbd
evade	evaded	Iv1d	Iv1dId
reappear	reappeared	"ri@p7R	"ri@p7d
send	sent	sEnd	sEnt
declare	declared	dIkl8R	dIkl8d
reacts	reacted	rI{kts	rI{ktId
miaows	miaowed	mi6z	mi6d
heat	heated	hit	hitId
shed	shed	SEd	SEd
sets	set	sEts	sEt
rebuke	rebuked	rIbjuk	rIbjukt
cook	cooked	kUk	kUkt
have	had	h{v	h{d
invade	invaded	Inv1d	Inv1dId
barbarizes	barbarized	b#b@r2zIz	b#b@r2zd
straiten	straitened	str1tH	str1tHd
receive	received	rIsiv	rIsivd
speculate	speculated	spEkjUl1t	spEkjUl1tId
dethrone	dethroned	dITr5n	dITr5nd
permit	permitted	p@mIt	p@mItId
recommends	recommended	"rEk@mEndz	"rEk@mEndId
decorate	decorated	dEk@r1t	dEk@r1tId
ramifies	ramified	r{mIf2z	r{mIf2d
bedeck	bedecked	bIdEk	bIdEkt
provides	provided	pr@v2dz	pr@v2dId
assays	assayed	@s1z	@s1d
fawn	fawned	f$n	f$nd
curls	curled	k3lz	k3ld
dances	danced	d#nsIz	d#nst
heightens	heightened	h2tHz	h2tHd
appease	appeased	@piz	@pizd
feel	felt	fil	fElt
conglomerates	conglomerated	k@nglQm@r1ts	k@nglQm@r1tId
confines	confined	k@nf2nz	k@nf2nd
itinerates	itinerated	ItIn@r1ts	ItIn@r1tId
tours	toured	t9z	t9d
nag	nagged	n{g	n{gd
drape	draped	dr1p	dr1pt
savvy	savvied	s{vI	s{vId
misses	missed	mIsIz	mIst
dips	dipped	dIps	dIpt
violates	violated	v2@l1ts	v2@l1tId
suppresses	suppressed	s@prEsIz	s@prEst
grinds	ground	gr2ndz	gr6nd
parks	parked	p#ks	p#kt
excommunicate	excommunicated	"Eksk@mjunIk1t	"Eksk@mjunIk1tId
sues	sued	suz	sud
dip	dipped	dIp	dIpt
derange	deranged	dIr1n_	dIr1n_d
negate	negated	nIg1t	nIg1tId
screens	screened	skrinz	skrind
gasp	gasped	g#sp	g#spt
concentrates	concentrated	kQns@ntr1ts	kQns@ntr1tId
wantons	wantoned	wQnt@nz	wQnt@nd
pauperizes	pauperized	p$p@r2zIz	p$p@r2zd
bobsleighs	bobsleighed	bQbsl1z	bQbsl1d
traffic	trafficked	tr{fIk	tr{fIkt
earn	earned	3n	3nd
tune	tuned	tjun	tjund
crushes	crushed	krVSIz	krVSt
wanton	wantoned	wQnt@n	wQnt@nd
mishear	misheard	"mIsh7R	"mIsh3d
restore	restored	rIst$R	rIst$d
perishes	perished	pErISIz	pErISt
flutes	fluted	fluts	flutId
bastardizes	bastardized	b{st@d2zIz	b{st@d2zd
conflate	conflated	k@nfl1t	k@nfl1tId
traffics	trafficked	tr{fIks	tr{fIkt
hail	hailed	h1l	h1ld
strains	strained	str1nz	str1nd
love	loved	lVv	lVvd
drift	drifted	drIft	drIftId
pauperize	pauperized	p$p@r2z	p$p@r2zd
feels	felt	filz	fElt
encounters	encountered	Ink6nt@z	Ink6nt@d
tour	toured	t9R	t9d
park	parked	p#k	p#kt
dimples	dimpled	dImpPz	dImpPd
dilapidate	dilapidated	dIl{pId1t	dIl{pId1tId
sellotape	sellotaped	sEl5t1p	sEl5t1pt
steel	steeled	stil	stild
take	took	t1k	tUk
investigate	investigated	InvEstIg1t	InvEstIg1tId
jar	jarred	_#R	_#d
masks	masked	m#sks	m#skt
captivates	captivated	k{ptIv1ts	k{ptIv1tId
appeases	appeased	@pizIz	@pizd
persist	persisted	p@sIst	p@sIstId
cry	cried	kr2	kr2d
suggest	suggested	s@_Est	s@_EstId
enliven	enlivened	Inl2vH	Inl2vHd
bluffs	bluffed	blVfs	blVft
sack	sacked	s{k	s{kt
jinx	jinxed	_INks	_INkst
cast	cast	k#st	k#st
rattles	rattled	r{tPz	r{tPd
nags	nagged	n{gz	n{gd
foreshortens	foreshortened	f$S$tHz	f$S$tHd
vamps	vamped	v{mps	v{mpt
steady	steadied	stEdI	stEdId
distracts	distracted	dIstr{kts	dIstr{ktId
metal	metalled	mEtP	mEtPd
waken	wakened	w1k@n	w1k@nd
last	lasted	l#st	l#stId
pepper	peppered	pEp@R	pEp@d
drives	drove	dr2vz	dr5v
suggests	suggested	s@_Ests	s@_EstId
ensure	ensured	InS$R	InS$d
grovel	grovelled	grQvP	grQvPd
confine	confined	k@nf2n	k@nf2nd
shelves	shelved	SElvz	SElvd
gasps	gasped	g#sps	g#spt
crisp	crisped	krIsp	krIspt
note	noted	n5t	n5tId
accounts	accounted	@k6nts	@k6ntId
wees	weed	wiz	wid
hit	hit	hIt	hIt
reek	reeked	rik	rikt
entrances	entranced	Intr#nsIz	Intr#nst
violate	violated	v2@l1t	v2@l1tId
sleep	slept	slip	slEpt
encounter	encountered	Ink6nt@R	Ink6nt@d
purges	purged	p3_Iz	p3_d
diminish	diminished	dImInIS	dImInISt
bristles	bristled	brIsPz	brIsPd
observes	observed	@bz3vz	@bz3vd
calves	calved	k#vz	k#vd
commend	commended	k@mEnd	k@mEndId
cries	cried	kr2z	kr2d
soils	soiled	s4lz	s4ld
vamp	vamped	v{mp	v{mpt
intermarry	intermarried	"Int@m{rI	"Int@m{rId
congratulates	congratulated	k@ngr{JUl1ts	k@ngr{JUl1tId
enact	enacted	In{kt	In{ktId
slumbers	slumbered	slVmb@z	slVmb@d
observe	observed	@bz3v	@bz3vd
claim	claimed	kl1m	kl1md
parry	parried	p{rI	p{rId
directs	directed	dIrEkts	dIrEktId
swoop	swooped	swup	swupt
foreshorten	foreshortened	f$S$tH	f$S$tHd
heal	hole	hil	h5l
propagandize	propagandized	"prQp@g{nd2z	"prQp@g{nd2zd
vend	vended	vEnd	vEndId
insult	insulted	InsVlt	InsVltId
tunes	tuned	tjunz	tjund
wobble	wobbled	wQbP	wQbPd
recognizes	recognized	rEk@gn2zIz	rEk@gn2zd
faces	faced	f1sIz	f1st
signify	signified	sIgnIf2	sIgnIf2d
tunnel	tunnelled	tVnP	tVnPd
sizzles	sizzled	sIzPz	sIzPd
lecture	lectured	lEkJ@R	lEkJ@d
regulate	regulated	rEgjUl1t	rEgjUl1tId
gibes	gibed	_2bz	_2bd
rub	rubbed	rVb	rVbd
transmute	transmuted	tr{nzmjut	tr{nzmjutId
glaze	glazed	gl1z	gl1zd
slap	slapped	sl{p	sl{pt
retaliates	retaliated	rIt{lI1ts	rIt{lI1tId
heighten	heightened	h2tH	h2tHd
wakens	wakened	w1k@nz	w1k@nd
deliquesces	deliquesced	"dElIkwEsIz	"dElIkwEst
twitch	twitched	twIJ	twIJt
subsidizes	subsidized	sVbsId2zIz	sVbsId2zd
disconcerts	disconcerted	"dIsk@ns3ts	"dIsk@ns3tId
loves	loved	lVvz	lVvd
spirit	spirited	spIrIt	spIrItId
full	fulled	fUl	fUld
drapes	draped	dr1ps	dr1pt
shelve	shelved	SElv	SElvd
subsidize	subsidized	sVbsId2z	sVbsId2zd
abound	abounded	@b6nd	@b6ndId
wither	withered	wID@R	wID@d
evades	evaded	Iv1dz	Iv1dId
concentrate	concentrated	kQns@ntr1t	kQns@ntr1tId
consubstantiates	consubstantiated	"kQns@bst{nSI1ts	"kQns@bst{nSI1tId
aggress	aggressed	@grEs	@grEst
befuddle	befuddled	bIfVdP	bIfVdPd
gibe	gibed	_2b	_2bd
admires	admired	@dm2@z	@dm2@d
cross-fertilizes	cross-fertilized	"krQsf3t@l2zIz	"krQsf3t@l2zd
refrain	refrained	rIfr1n	rIfr1nd
slump	slumped	slVmp	slVmpt
dethrones	dethroned	dITr5nz	dITr5nd
spoonfeed	spoonfed	spunfid	spunfEd
daze	dazed	d1z	d1zd
publicize	publicized	pVblIs2z	pVblIs2zd
bode	boded	b5d	b5dId
blow-dry	blow-dried	bl5dr2	bl5dr2d
crush	crushed	krVS	krVSt
masturbates	masturbated	m{st@b1ts	m{st@b1tId
bands	banded	b{ndz	b{ndId
belch	belched	bElJ	bElJt
spoonfeeds	spoonfed	spunfidz	spunfEd
admire	admired	@dm2@R	@dm2@d
emphasizes	emphasized	Emf@s2zIz	Emf@s2zd
bobsleigh	bobsleighed	bQbsl1	bQbsl1d
demobilize	demobilized	dim5bIl2z	dim5bIl2zd
heals	hole	hilz	h5l
notes	noted	n5ts	n5tId
commends	commended	k@mEndz	k@mEndId
ransoms	ransomed	r{ns@mz	r{ns@md
vocalizes	vocalized	v5k@l2zIz	v5k@l2zd
generalizes	generalized	_En@r@l2zIz	_En@r@l2zd
metals	metalled	mEtPz	mEtPd
recommend	recommended	"rEk@mEnd	"rEk@mEndId
strengthen	strengthened	strENTH	strENTHd
trawl	trawled	tr$l	tr$ld
exonerate	exonerated	IgzQn@r1t	IgzQn@r1tId
sleeps	slept	slips	slEpt
steels	steeled	stilz	stild
takes	took	t1ks	tUk
scar	scarred	sk#R	sk#d
downs	downed	d6nz	d6nd
compel	compelled	k@mpEl	k@mpEld
befuddles	befuddled	bIfVdPz	bIfVdPd
straitens	straitened	str1tHz	str1tHd
declares	declared	dIkl8z	dIkl8d
dodder	doddered	dQd@R	dQd@d
bastardize	bastardized	b{st@d2z	b{st@d2zd
deceives	deceived	dIsivz	dIsivd
sip	sipped	sIp	sIpt
ramify	ramified	r{mIf2	r{mIf2d
sew	sewed	s5	s5d
intermarries	intermarried	"Int@m{rIz	"Int@m{rId
congratulate	congratulated	k@ngr{JUl1t	k@ngr{JUl1tId
circulates	circulated	s3kjUl1ts	s3kjUl1tId
charges	charged	J#_Iz	J#_d
bear	bore	b8R	b$R
headline	headlined	hEdl2n	hEdl2nd
line	lined	l2n	l2nd
split	split	splIt	splIt
sips	sipped	sIps	sIpt
sweats	sweated	swEts	swEtId
miscall	miscalled	"mIsk$l	"mIsk$ld
harries	harried	h{rIz	h{rId
cooks	cooked	kUks	kUkt
relish	relished	rElIS	rElISt
reeks	reeked	riks	rikt
berates	berated	bIr1ts	bIr1tId
hails	hailed	h1lz	h1ld
prod	prodded	prQd	prQdId
expose	exposed	Iksp5z	Iksp5zd
wedges	wedged	wE_Iz	wE_d
rape	raped	r1p	r1pt
expresses	expressed	IksprEsIz	IksprEst
twitches	twitched	twIJIz	twIJt
direct	directed	dIrEkt	dIrEktId
lines	lined	l2nz	l2nd
headlines	headlined	hEdl2nz	hEdl2nd
signifies	signified	sIgnIf2z	sIgnIf2d
heats	heated	hits	hitId
ignore	ignored	Ign$R	Ign$d
persuades	persuaded	p@sw1dz	p@sw1dId
grind	ground	gr2nd	gr6nd
spares	spared	sp8z	sp8d
scare	scared	sk8R	sk8d
coddles	coddled	kQdPz	kQdPd
fingerprint	fingerprinted	fINg@prInt	fINg@prIntId
drive	drove	dr2v	dr5v
band	banded	b{nd	b{ndId
pitch	pitched	pIJ	pIJt
disdain	disdained	dIsd1n	dIsd1nd
humbles	humbled	hVmbPz	hVmbPd
repays	repaid	rip1z	rip1d
metals	metalled	mEtPz	mEtPd
ripen	ripened	r2p@n	r2p@nd
probe	probed	pr5b	pr5bd
unbend	unbent	"VnbEnd	"VnbEnt
jars	jarred	_#z	_#d
gesticulates	gesticulated	_EstIkjUl1ts	_EstIkjUl1tId
fate	fated	f1t	f1tId
spooks	spooked	spuks	spukt
yachts	yachted	jQts	jQtId
strain	strained	str1n	str1nd
belts	belted	bElts	bEltId
dangles	dangled	d{NgPz	d{NgPd
publicizes	publicized	pVblIs2zIz	pVblIs2zd
rattle	rattled	r{tP	r{tPd
masturbate	masturbated	m{st@b1t	m{st@b1tId
excommunicates	excommunicated	"Eksk@mjunIk1ts	"Eksk@mjunIk1tId
brawls	brawled	br$lz	br$ld
encapsulates	encapsulated	Ink{psjUl1ts	Ink{psjUl1tId
wobbles	wobbled	wQbPz	wQbPd
dispatches	dispatched	dIsp{JIz	dIsp{Jt
substitutes	substituted	sVbstItjuts	sVbstItjutId
aggresses	aggressed	@grEsIz	@grEst
mask	masked	m#sk	m#skt
washes	washed	wQSIz	wQSt
spirits	spirited	spIrIts	spIrItId
hex	hexed	hEks	hEkst
task	tasked	t#sk	t#skt
account	accounted	@k6nt	@k6ntId
down	downed	d6n	d6nd
generalize	generalized	_En@r@l2z	_En@r@l2zd
trawls	trawled	tr$lz	tr$ld
berate	berated	bIr1t	bIr1tId
traipse	traipsed	tr1ps	tr1pst
fates	fated	f1ts	f1tId
kowtows	kowtowed	"k6t6z	"k6t6d
headline	headlined	hEdl2n	hEdl2nd
halt	halted	h$lt	h$ltId
disdains	disdained	dIsd1nz	dIsd1nd
assesses	assessed	@sEsIz	@sEst
outvie	outvied	"6tv2	"6tv2d
permits	permitted	p@mIts	p@mItId
activate	activated	{ktIv1t	{ktIv1tId
jinxes	jinxed	_INksIz	_INkst
bugger	buggered	bVg@R	bVg@d
sews	sewed	s5z	s5d
rebukes	rebuked	rIbjuks	rIbjukt
persists	persisted	p@sIsts	p@sIstId
censor	censored	sEns@R	sEns@d
prostitute	prostituted	prQstItjut	prQstItjutId
restrict	restricted	rIstrIkt	rIstrIktId
slanders	slandered	sl#nd@z	sl#nd@d
scares	scared	sk8z	sk8d
reorientates	reorientated	"ri$rIEnt1ts	"ri$rIEnt1tId
prong	pronged	prQN	prQNd
kowtow	kowtowed	"k6t6	"k6t6d
has	had	h{z	h{d
recognize	recognized	rEk@gn2z	rEk@gn2zd
fingerprints	fingerprinted	fINg@prInts	fINg@prIntId
walk	walked	w$k	w$kt
tunnels	tunnelled	tVnPz	tVnPd
express	expressed	IksprEs	IksprEst
sizzle	sizzled	sIzP	sIzPd
oversleep	overslept	"5v@slip	"5v@slEpt
escape	escaped	Isk1p	Isk1pt
confesses	confessed	k@nfEsIz	k@nfEst
dangle	dangled	d{NgP	d{NgPd
claims	claimed	kl1mz	kl1md
wee	weed	wi	wid
sweat	sweated	swEt	swEtId
banters	bantered	b{nt@z	b{nt@d
escapes	escaped	Isk1ps	Isk1pt
confess	confessed	k@nfEs	k@nfEst
demobilize	demobilized	dim5bIl2z	dim5bIl2zd
metricates	metricated	mEtrI"k1ts	mEtrI"k1tId
withhold	withheld	wIDh5ld	wIDhEld
rapes	raped	r1ps	r1pt
refrains	refrained	rIfr1nz	rIfr1nd
demonetize	demonetized	"dimVnIt2z	"dimVnIt2zd
loft	lofted	lQft	lQftId
belches	belched	bElJIz	bElJt
spank	spanked	sp{Nk	sp{Nkt
muckrakes	muckraked	mVkr1ks	mVkr1kt
stands	stood	st{ndz	stUd
possesses	possessed	p@zEsIz	p@zEst
lamb	lambed	l{m	l{md
finalize	finalized	f2n@l2z	f2n@l2zd
patrol	patrolled	p@tr5l	p@tr5ld
lingers	lingered	lINg@z	lINg@d
re-cover	re-covered	"rikVv@R	"rikVv@d
settles	settled	sEtPz	sEtPd
amasses	amassed	@m{sIz	@m{st
farrows	farrowed	f{r5z	f{r5d
wells	welled	wElz	wEld
put	put	pUt	pUt
quadruple	quadrupled	kwQdrUpP	kwQdrUpPd
incapacitate	incapacitated	"Ink@p{sIt1t	"Ink@p{sIt1tId
skims	skimmed	skImz	skImd
denude	denuded	dInjud	dInjudId
owns	owned	5nz	5nd
grumbles	grumbled	grVmbPz	grVmbPd
amuses	amused	@mjuzIz	@mjuzd
yens	yenned	jEnz	jEnd
hold	held	h5ld	hEld
rinse	rinsed	rIns	rInst
bans	banned	b{nz	b{nd
revises	revised	rIv2zIz	rIv2zd
hearten	heartened	h#tH	h#tHd
contribute	contributed	k@ntrIbjut	k@ntrIbjutId
legitimize	legitimized	lI_ItIm2z	lI_ItIm2zd
acknowledges	acknowledged	@knQlI_Iz	@knQlI_d
examine	examined	Igz{mIn	Igz{mInd
aims	aimed	1mz	1md
traduces	traduced	tr@djusIz	tr@djust
pressures	pressured	prES@z	prES@d
flounder	floundered	fl6nd@R	fl6nd@d
puddle	puddled	pVdP	pVdPd
springs	sprung	sprINz	sprVN
include	included	Inklud	InkludId
blackens	blackened	bl{k@nz	bl{k@nd
expect	expected	IkspEkt	IkspEktId
subserve	subserved	s@bs3v	s@bs3vd
clerks	clerked	kl#ks	kl#kt
nauseate	nauseated	n$sI1t	n$sI1tId
groins	groined	gr4nz	gr4nd
wipe	wiped	w2p	w2pt
experiences	experienced	Iksp7r7nsIz	Iksp7r7nst
heightens	heightened	h2tHz	h2tHd
educate	educated	E_Uk1t	E_Uk1tId
know	knew	n5	nju
leans	leant	linz	lEnt
fleece	fleeced	flis	flist
triples	tripled	trIpPz	trIpPd
subtract	subtracted	s@btr{kt	s@btr{ktId
stems	stemmed	stEmz	stEmd
challenges	challenged	J{lIn_Iz	J{lIn_d
field	fielded	fild	fildId
stares	stared	st8z	st8d
bifurcates	bifurcated	b2f@k1ts	b2f@k1tId
consumes	consumed	k@nsjumz	k@nsjumd
sham	shammed	S{m	S{md
lambast	lambasted	l{mb1st	l{mb1stId
challenge	challenged	J{lIn_	J{lIn_d
drills	drilled	drIlz	drIld
choke	choked	J5k	J5kt
discard	discarded	dIsk#d	dIsk#dId
offend	offended	@fEnd	@fEndId
syndicates	syndicated	sIndIk1ts	sIndIk1tId
cycle	cycled	s2kP	s2kPd
narrates	narrated	n@r1ts	n@r1tId
braces	braced	br1sIz	br1st
accomplish	accomplished	@kVmplIS	@kVmplISt
lurks	lurked	l3ks	l3kt
pats	patted	p{ts	p{tId
swaddle	swaddled	swQdP	swQdPd
castrates	castrated	k{str1ts	k{str1tId
pesters	pestered	pEst@z	pEst@d
roar	roared	r$R	r$d
delegates	delegated	dElIg1ts	dElIg1tId
composes	composed	k@mp5zIz	k@mp5zd
adopts	adopted	@dQpts	@dQptId
dives	dove	d2vz	d5v
drill	drilled	drIl	drIld
beggars	beggared	bEg@z	bEg@d
dash	dashed	d{S	d{St
slackens	slackened	sl{k@nz	sl{k@nd
musters	mustered	mVst@z	mVst@d
hound	hounded	h6nd	h6ndId
oversells	oversold	"5v@sElz	"5v@s5ld
adorn	adorned	@d$n	@d$nd
counterfeit	counterfeited	k6nt@fIt	k6nt@fItId
barrages	barraged	b{r#ZIz	b{r#Zd
pipe	piped	p2p	p2pt
sublet	sublet	"sVblEt	"sVblEt
numbers	numbered	nVmb@z	nVmb@d
ponders	pondered	pQnd@z	pQnd@d
miffs	miffed	mIfs	mIft
gazes	gazed	g1zIz	g1zd
use	used	juz	juzd
prize	prized	pr2z	pr2zd
jags	jagged	_{gz	_{gd
vibrate	vibrated	v2br1t	v2br1tId
charters	chartered	J#t@z	J#t@d
transmogrify	transmogrified	tr{nzmQgrIf2	tr{nzmQgrIf2d
dams	dammed	d{mz	d{md
covers	covered	kVv@z	kVv@d
parades	paraded	p@r1dz	p@r1dId
gawp	gawped	g$p	g$pt
whirrs	whirred	w3z	w3d
cool	cooled	kul	kuld
urinates	urinated	j9rIn1ts	j9rIn1tId
double	doubled	dVbP	dVbPd
sandblast	sandblasted	s{ndbl#st	s{ndbl#stId
advances	advanced	@dv#nsIz	@dv#nst
breeds	bred	bridz	brEd
unload	unloaded	"Vnl5d	"Vnl5dId
examines	examined	Igz{mInz	Igz{mInd
hashes	hashed	h{SIz	h{St
disabuses	disabused	"dIs@bjuzIz	"dIs@bjuzd
slosh	sloshed	slQS	slQSt
panics	panicked	p{nIks	p{nIkt
succumbs	succumbed	s@kVmz	s@kVmd
mimes	mimed	m2mz	m2md
quibble	quibbled	kwIbP	kwIbPd
wishes	wished	wISIz	wISt
conquer	conquered	kQNk@R	kQNk@d
fancies	fancied	f{nsIz	f{nsId
cooperates	cooperated	k5Qp@r1ts	k5Qp@r1tId
steers	steered	st7z	st7d
flinches	flinched	flInJIz	flInJt
enchants	enchanted	InJ#nts	InJ#ntId
snog	snogged	snQg	snQgd
rocks	rocked	rQks	rQkt
nasalize	nasalized	n1z@l2z	n1z@l2zd
preconceive	preconceived	"prik@nsiv	"prik@nsivd
entreats	entreated	Intrits	IntritId
transport	transported	tr{nsp$t	tr{nsp$tId
punishes	punished	pVnISIz	pVnISt
coat	coated	k5t	k5tId
funks	funked	fVNks	fVNkt
localizes	localized	l5k@l2zIz	l5k@l2zd
floor	floored	fl$R	fl$d
enrapture	enraptured	Inr{pJ@R	Inr{pJ@d
stones	stoned	st5nz	st5nd
cater	catered	k1t@R	k1t@d
manufactures	manufactured	"m{njUf{kJ@z	"m{njUf{kJ@d
whale	whaled	w1l	w1ld
receipt	receipted	rIsit	rIsitId
lacks	lacked	l{ks	l{kt
deodorizes	deodorized	di5d@r2zIz	di5d@r2zd
disappears	disappeared	"dIs@p7z	"dIs@p7d
sails	sailed	s1lz	s1ld
resemble	resembled	rIzEmbP	rIzEmbPd
reanimates	reanimated	ri{nIm1ts	ri{nIm1tId
sniffs	sniffed	snIfs	snIft
approximate	approximated	@prQksIm1t	@prQksIm1tId
illumines	illumined	IlumInz	IlumInd
goes	went	g5z	wEnt
crimps	crimped	krImps	krImpt
amble	ambled	{mbP	{mbPd
twits	twitted	twIts	twItId
recaps	recapped	rik{ps	rik{pt
envelop	enveloped	InvEl@p	InvEl@pt
vitrifies	vitrified	vItrIf2z	vItrIf2d
oblige	obliged	@bl2_	@bl2_d
mount	mounted	m6nt	m6ntId
orient	oriented	$r7nt	$r7ntId
destructs	destructed	dIstrVkts	dIstrVktId
cease	ceased	sis	sist
experiments	experimented	IkspErIm@nts	IkspErIm@ntId
opine	opined	5p2n	5p2nd
arrives	arrived	@r2vz	@r2vd
quaff	quaffed	kwQf	kwQft
slow	slowed	sl5	sl5d
feathers	feathered	fED@z	fED@d
manufacture	manufactured	"m{njUf{kJ@R	"m{njUf{kJ@d
store	stored	st$R	st$d
decolonize	decolonized	"dikQl@n2z	"dikQl@n2zd
infect	infected	InfEkt	InfEktId
freezes	froze	frizIz	fr5z
forbear	forbore	f$b8R	f$b$R
installs	installed	Inst$lz	Inst$ld
craves	craved	kr1vz	kr1vd
spellbind	spellbound	spElb2nd	spElb6nd
hands	handed	h{ndz	h{ndId
courts	courted	k$ts	k$tId
transfer	transferred	tr{nsf3R	tr{nsf3d
sniggers	sniggered	snIg@z	snIg@d
snarls	snarled	sn#lz	sn#ld
overtrumps	overtrumped	"5v@trVmps	"5v@trVmpt
humanizes	humanized	hjum@n2zIz	hjum@n2zd
coddle	coddled	kQdP	kQdPd
loot	looted	lut	lutId
arraigns	arraigned	@r1nz	@r1nd
invoke	invoked	Inv5k	Inv5kt
marinade	marinaded	"m{rIn1d	"m{rIn1dId
materializes	materialized	m@t7r7l2zIz	m@t7r7l2zd
alert	alerted	@l3t	@l3tId
engrosses	engrossed	Ingr5sIz	Ingr5st
bolsters	bolstered	b5lst@z	b5lst@d
palatalize	palatalized	p{l@t@l2z	p{l@t@l2zd
digests	digested	dI_Ests	dI_EstId
worry	worried	wVrI	wVrId
pine	pined	p2n	p2nd
hallmark	hallmarked	h$lm#k	h$lm#kt
introduces	introduced	"Intr@djusIz	"Intr@djust
stifle	stifled	st2fP	st2fPd
jelly	jellied	_ElI	_ElId
sate	sated	s1t	s1tId
rucks	rucked	rVks	rVkt
abstains	abstained	@bst1nz	@bst1nd
result	resulted	rIzVlt	rIzVltId
perpetuate	perpetuated	p@pEJU1t	p@pEJU1tId
smash	smashed	sm{S	sm{St
defuse	defused	"difjuz	"difjuzd
weld	welded	wEld	wEldId
carries	carried	k{rIz	k{rId
alleviates	alleviated	@livI1ts	@livI1tId
aspire	aspired	@sp2@R	@sp2@d
exchanges	exchanged	IksJ1n_Iz	IksJ1n_d
kiss	kissed	kIs	kIst
bicycle	bicycled	b2sIkP	b2sIkPd
snowballs	snowballed	sn5b$lz	sn5b$ld
touch	touched	tVJ	tVJt
surrounds	surrounded	s@r6ndz	s@r6ndId
grounds	grounded	gr6ndz	gr6ndId
de-ices	de-iced	"di2sIz	"di2st
clog	clogged	klQg	klQgd
relate	related	rIl1t	rIl1tId
solves	solved	sQlvz	sQlvd
miaow	miaowed	mi6	mi6d
channels	channelled	J{nPz	J{nPd
inflames	inflamed	Infl1mz	Infl1md
hisses	hissed	hIsIz	hIst
metamorphoses	metamorphosed	"mEt@m$f5zIz	"mEt@m$f5zd
assists	assisted	@sIsts	@sIstId
shins	shinned	SInz	SInd
combines	combined	k@mb2nz	k@mb2nd
accomplishes	accomplished	@kVmplISIz	@kVmplISt
nauseates	nauseated	n$sI1ts	n$sI1tId
howl	howled	h6l	h6ld
circumvents	circumvented	"s3k@mvEnts	"s3k@mvEntId
displease	displeased	dIspliz	dIsplizd
snogs	snogged	snQgz	snQgd
bump	bumped	bVmp	bVmpt
eavesdrops	eavesdropped	ivzdrQps	ivzdrQpt
bypasses	bypassed	b2p#sIz	b2p#st
impresses	impressed	ImprEsIz	ImprEst
apprises	apprised	@pr2zIz	@pr2zd
intercept	intercepted	"Int@sEpt	"Int@sEptId
honk	honked	hQNk	hQNkt
pursues	pursued	p@sjuz	p@sjud
shin	shinned	SIn	SInd
cashes	cashed	k{SIz	k{St
decide	decided	dIs2d	dIs2dId
holds	held	h5ldz	hEld
sniff	sniffed	snIf	snIft
misspells	misspelt	"mIsspElz	"mIsspElt
markets	marketed	m#kIts	m#kItId
lubricate	lubricated	lubrIk1t	lubrIk1tId
utters	uttered	Vt@z	Vt@d
whack	whacked	w{k	w{kt
copes	coped	k5ps	k5pt
whack	whacked	w{k	w{kt
prefers	preferred	prIf3z	prIf3d
foreknows	foreknew	f$n5z	f$nju
illumines	illumined	IlumInz	IlumInd
preface	prefaced	prEfIs	prEfIst
tiles	tiled	t2lz	t2ld
oversells	oversold	"5v@sElz	"5v@s5ld
come	came	kVm	k1m
cleanses	cleansed	klEnzIz	klEnzd
enmeshes	enmeshed	InmESIz	InmESt
diagnoses	diagnosed	d2@gn5zIz	d2@gn5zd
insert	inserted	Ins3t	Ins3tId
improve	improved	Impruv	Impruvd
asterisks	asterisked	{st@rIsks	{st@rIskt
fragment	fragmented	fr{gmEnt	fr{gmEntId
hoaxes	hoaxed	h5ksIz	h5kst
hams	hammed	h{mz	h{md
gambol	gambolled	g{mbP	g{mbPd
pours	poured	p$z	p$d
interbreed	interbred	"Int@brid	"Int@brEd
disintegrates	disintegrated	dIsIntIgr1ts	dIsIntIgr1tId
hammers	hammered	h{m@z	h{m@d
striate	striated	str21t	str21tId
illustrates	illustrated	Il@str1ts	Il@str1tId
actuates	actuated	{ktjU1ts	{ktjU1tId
enmesh	enmeshed	InmES	InmESt
tarnishes	tarnished	t#nISIz	t#nISt
beads	beaded	bidz	bidId
hedgehop	hedgehopped	hE_hQp	hE_hQpt
knot	knotted	nQt	nQtId
tins	tinned	tInz	tInd
jug	jugged	_Vg	_Vgd
evolve	evolved	IvQlv	IvQlvd
shackles	shackled	S{kPz	S{kPd
floors	floored	fl$z	fl$d
domineer	domineered	"dQmIn7R	"dQmIn7d
unsaddles	unsaddled	"Vns{dPz	"Vns{dPd
bashes	bashed	b{SIz	b{St
adjust	adjusted	@_Vst	@_VstId
ingrain	ingrained	"Ingr1n	"Ingr1nd
concretes	concreted	kQNkrits	kQNkritId
police	policed	p@lis	p@list
execrates	execrated	EksIkr1ts	EksIkr1tId
distrust	distrusted	dIstrVst	dIstrVstId
ambles	ambled	{mbPz	{mbPd
dismantles	dismantled	dIsm{ntPz	dIsm{ntPd
pestle	pestled	pEsP	pEsPd
attempts	attempted	@tEmpts	@tEmptId
dismember	dismembered	dIsmEmb@R	dIsmEmb@d
forebode	foreboded	f$b5d	f$b5dId
engage	engaged	Ing1_	Ing1_d
detest	detested	dItEst	dItEstId
waives	waived	w1vz	w1vd
upends	upended	VpEndz	VpEndId
stab	stabbed	st{b	st{bd
macadamize	macadamized	m@k{d@m2z	m@k{d@m2zd
retool	retooled	"ritul	"rituld
signs	signed	s2nz	s2nd
salaam	salaamed	s@l#m	s@l#md
lubricates	lubricated	lubrIk1ts	lubrIk1tId
delivers	delivered	dIlIv@z	dIlIv@d
conjoins	conjoined	k@n_4nz	k@n_4nd
prognosticate	prognosticated	prQgnQstIk1t	prQgnQstIk1tId
share	shared	S8R	S8d
rustproofs	rustproofed	rVstprufs	rVstpruft
slices	sliced	sl2sIz	sl2st
alerts	alerted	@l3ts	@l3tId
prinks	prinked	prINks	prINkt
yelps	yelped	jElps	jElpt
mimic	mimicked	mImIk	mImIkt
impersonate	impersonated	Imp3s@n1t	Imp3s@n1tId
immerses	immersed	Im3sIz	Im3st
tie-dye	tie-dyed	t2d2	t2d2d
smooth	smoothed	smuD	smuDd
scrag	scragged	skr{g	skr{gd
cancels	cancelled	k{nsPz	k{nsPd
tie-dyes	tie-dyed	t2d2z	t2d2d
alleviate	alleviated	@livI1t	@livI1tId
hires	hired	h2@z	h2@d
rumple	rumpled	rVmpP	rVmpPd
thinks	thought	TINks	T$t
causes	caused	k$zIz	k$zd
complicates	complicated	kQmplIk1ts	kQmplIk1tId
countermand	countermanded	"k6nt@m#nd	"k6nt@m#ndId
enamel	enamelled	In{mP	In{mPd
purveys	purveyed	p@v1z	p@v1d
insist	insisted	InsIst	InsIstId
hop	hopped	hQp	hQpt
maturate	maturated	m{tjUr1t	m{tjUr1tId
plonk	plonked	plQNk	plQNkt
commands	commanded	k@m#ndz	k@m#ndId
derails	derailed	dIr1lz	dIr1ld
reject	rejected	rI_Ekt	rI_EktId
revolves	revolved	rIvQlvz	rIvQlvd
lobs	lobbed	lQbz	lQbd
frays	frayed	fr1z	fr1d
preoccupies	preoccupied	"priQkjUp2z	"priQkjUp2d
chlorinates	chlorinated	kl$rIn1ts	kl$rIn1tId
exits	exited	EksIts	EksItId
attitudinize	attitudinized	"{tItjudIn2z	"{tItjudIn2zd
govern	governed	gVvH	gVvHd
airdrops	airdropped	8drQps	8drQpt
dye	dyed	d2	d2d
retouches	retouched	"ritVJIz	"ritVJt
enjoin	enjoined	In_4n	In_4nd
blacken	blackened	bl{k@n	bl{k@nd
like	liked	l2k	l2kt
meddle	meddled	mEdP	mEdPd
pinion	pinioned	pInj@n	pInj@nd
steer	steered	st7R	st7d
normalize	normalized	n$m@l2z	n$m@l2zd
links	linked	lINks	lINkt
miaows	miaowed	mi6z	mi6d
glimmer	glimmered	glIm@R	glIm@d
tests	tested	tEsts	tEstId
bash	bashed	b{S	b{St
descends	descended	dIsEndz	dIsEndId
bowl	bowled	b5l	b5ld
glimmer	glimmered	glIm@R	glIm@d
reads	read	ridz	rEd
risks	risked	rIsks	rIskt
slots	slotted	slQts	slQtId
guesses	guessed	gEsIz	gEst
clamp	clamped	kl{mp	kl{mpt
enfranchise	enfranchised	Infr{nJ2z	Infr{nJ2zd
belches	belched	bElJIz	bElJt
reckons	reckoned	rEk@nz	rEk@nd
cavorts	cavorted	k@v$ts	k@v$tId
maligns	maligned	m@l2nz	m@l2nd
intercalate	intercalated	Int3k@l1t	Int3k@l1tId
reckon	reckoned	rEk@n	rEk@nd
perceives	perceived	p@sivz	p@sivd
shouts	shouted	S6ts	S6tId
detests	detested	dItEsts	dItEstId
peck	pecked	pEk	pEkt
digest	digested	dI_Est	dI_EstId
predicts	predicted	prIdIkts	prIdIktId
pinks	pinked	pINks	pINkt
humidifies	humidified	hjumIdIf2z	hjumIdIf2d
wank	wanked	w{Nk	w{Nkt
whispers	whispered	wIsp@z	wIsp@d
fixate	fixated	fIks1t	fIks1tId
blend	blent	blEnd	blEnt
curves	curved	k3vz	k3vd
whacks	whacked	w{ks	w{kt
misreports	misreported	"mIsrIp$ts	"mIsrIp$tId
screams	screamed	skrimz	skrimd
allays	allayed	@l1z	@l1d
boasts	boasted	b5sts	b5stId
berates	berated	bIr1ts	bIr1tId
cleanse	cleansed	klEnz	klEnzd
occur	occurred	@k3R	@k3d
peaches	peached	piJIz	piJt
exterminate	exterminated	Ikst3mIn1t	Ikst3mIn1tId
tolerates	tolerated	tQl@r1ts	tQl@r1tId
warns	warned	w$nz	w$nd
whine	whined	w2n	w2nd
register	registered	rE_Ist@R	rE_Ist@d
engages	engaged	Ing1_Iz	Ing1_d
pressures	pressured	prES@z	prES@d
hallucinates	hallucinated	h@lusIn1ts	h@lusIn1tId
discovers	discovered	dIskVv@z	dIskVv@d
defeats	defeated	dIfits	dIfitId
flatters	flattered	fl{t@z	fl{t@d
governs	governed	gVvHz	gVvHd
overhears	overheard	"5v@h7z	"5v@h3d
bivouac	bivouacked	bIvU{k	bIvU{kt
laments	lamented	l@mEnts	l@mEntId
earths	earthed	3Ts	3Tt
forks	forked	f$ks	f$kt
inspect	inspected	InspEkt	InspEktId
yen	yenned	jEn	jEnd
deposits	deposited	dIpQzIts	dIpQzItId
discerns	discerned	dIs3nz	dIs3nd
scrimshank	scrimshanked	skrImS{Nk	skrImS{Nkt
crouches	crouched	kr6JIz	kr6Jt
daubs	daubed	d$bz	d$bd
coins	coined	k4nz	k4nd
pongs	ponged	pQNz	pQNd
exhibit	exhibited	IgzIbIt	IgzIbItId
repoint	repointed	"rip4nt	"rip4ntId
lengthens	lengthened	lENT@nz	lENT@nd
mummifies	mummified	mVmIf2z	mVmIf2d
shatter	shattered	S{t@R	S{t@d
wafts	wafted	w#fts	w#ftId
immolate	immolated	Im5l1t	Im5l1tId
hearkens	hearkened	h#k@nz	h#k@nd
corns	corned	k$nz	k$nd
retain	retained	rIt1n	rIt1nd
gulls	gulled	gVlz	gVld
gauge	gauged	g1_	g1_d
butters	buttered	bVt@z	bVt@d
convert	converted	k@nv3t	k@nv3tId
assign	assigned	@s2n	@s2nd
pardon	pardoned	p#dH	p#dHd
overlook	overlooked	"5v@lUk	"5v@lUkt
parachute	parachuted	p{r@Sut	p{r@SutId
containerizes	containerized	k@nt1n@r2zIz	k@nt1n@r2zd
facilitate	facilitated	f@sIlIt1t	f@sIlIt1tId
squawk	squawked	skw$k	skw$kt
happens	happened	h{p@nz	h{p@nd
ripostes	riposted	rIpQsts	rIpQstId
premieres	premiered	prEmI8z	prEmI8d
reprobates	reprobated	rEpr5b1ts	rEpr5b1tId
echoes	echoed	Ek5z	Ek5d
gardens	gardened	g#dHz	g#dHd
outranges	outranged	"6tr1n_Iz	"6tr1n_d
plunges	plunged	plVn_Iz	plVn_d
sever	severed	sEv@R	sEv@d
acidify	acidified	@sIdIf2	@sIdIf2d
conceptualize	conceptualized	k@nsEpJ9l2z	k@nsEpJ9l2zd
undeceives	undeceived	"VndIsivz	"VndIsivd
plenish	plenished	plEnIS	plEnISt
brighten	brightened	br2tH	br2tHd
evaluate	evaluated	Iv{ljU1t	Iv{ljU1tId
overthrows	overthrew	"5v@Tr5z	"5v@Tru
recreates	recreated	"rikri1ts	"rikri1tId
pad	padded	p{d	p{dId
inherits	inherited	InhErIts	InhErItId
barrage	barraged	b{r#Z	b{r#Zd
horrifies	horrified	hQrIf2z	hQrIf2d
deject	dejected	dI_Ekt	dI_EktId
pall	palled	p$l	p$ld
sleet	sleeted	slit	slitId
redirects	redirected	"ridIrEkts	"ridIrEktId
pre-exist	pre-existed	"priIgzIst	"priIgzIstId
well	welled	wEl	wEld
fondle	fondled	fQndP	fQndPd
gifts	gifted	gIfts	gIftId
yelp	yelped	jElp	jElpt
discourages	discouraged	dIskVrI_Iz	dIskVrI_d
enhances	enhanced	Inh#nsIz	Inh#nst
reunite	reunited	"rijun2t	"rijun2tId
scrimmages	scrimmaged	skrImI_Iz	skrImI_d
employ	employed	Impl4	Impl4d
confuses	confused	k@nfjuzIz	k@nfjuzd
label	labelled	l1bP	l1bPd
censors	censored	sEns@z	sEns@d
renders	rendered	rEnd@z	rEnd@d
forbears	forbore	f$b8z	f$b$R
palatalize	palatalized	p{l@t@l2z	p{l@t@l2zd
attests	attested	@tEsts	@tEstId
promulgate	promulgated	prQmPg1t	prQmPg1tId
taints	tainted	t1nts	t1ntId
defalcate	defalcated	dif{lk1t	dif{lk1tId
supplant	supplanted	s@pl#nt	s@pl#ntId
boards	boarded	b$dz	b$dId
redeploys	redeployed	"ridIpl4z	"ridIpl4d
bedews	bedewed	bIdjuz	bIdjud
involves	involved	InvQlvz	InvQlvd
inspires	inspired	Insp2@z	Insp2@d
specialize	specialized	spES@l2z	spES@l2zd
blends	blent	blEndz	blEnt
attract	attracted	@tr{kt	@tr{ktId
pink	pinked	pINk	pINkt
baby	babied	b1bI	b1bId
slouches	slouched	sl6JIz	sl6Jt
personalize	personalized	p3sH@l2z	p3sH@l2zd
intrigues	intrigued	Intrigz	Intrigd
loots	looted	luts	lutId
flunks	flunked	flVNks	flVNkt
jingles	jingled	_INgPz	_INgPd
attire	attired	@t2@R	@t2@d
powers	powered	p6@z	p6@d
boo	booed	bu	bud
flushes	flushed	flVSIz	flVSt
stand	stood	st{nd	stUd
trepans	trepanned	trIp{nz	trIp{nd
detonates	detonated	dEt@n1ts	dEt@n1tId
superabounds	superabounded	"sup@r@b6ndz	"sup@r@b6ndId
fulfil	fulfilled	fUlfIl	fUlfIld
emerge	emerged	Im3_	Im3_d
defrosts	defrosted	"difrQsts	"difrQstId
contrasts	contrasted	k@ntr#sts	k@ntr#stId
estrange	estranged	Istr1n_	Istr1n_d
habilitates	habilitated	h@bIlIt1ts	h@bIlIt1tId
shatters	shattered	S{t@z	S{t@d
spits	spit	spIts	spIt
scolds	scolded	sk5ldz	sk5ldId
forge	forged	f$_	f$_d
crumbles	crumbled	krVmbPz	krVmbPd
predict	predicted	prIdIkt	prIdIktId
reel	reeled	ril	rild
sledges	sledged	slE_Iz	slE_d
simplify	simplified	sImplIf2	sImplIf2d
form	formed	f$m	f$md
pacifies	pacified	p{sIf2z	p{sIf2d
iterates	iterated	It@r1ts	It@r1tId
removes	removed	rImuvz	rImuvd
allows	allowed	@l6z	@l6d
exhilarate	exhilarated	IgzIl@r1t	IgzIl@r1tId
goofs	goofed	gufs	guft
complement	complemented	kQmplImEnt	kQmplImEntId
interchanges	interchanged	"Int@J1n_Iz	"Int@J1n_d
hope	hoped	h5p	h5pt
pot	potted	pQt	pQtId
broaden	broadened	br$dH	br$dHd
promulgates	promulgated	prQmPg1ts	prQmPg1tId
hugs	hugged	hVgz	hVgd
frank	franked	fr{Nk	fr{Nkt
entomb	entombed	Intum	Intumd
hoaxes	hoaxed	h5ksIz	h5kst
mistakes	mistook	mIst1ks	mIstUk
describe	described	dIskr2b	dIskr2bd
theorize	theorized	T7r2z	T7r2zd
slot	slotted	slQt	slQtId
woos	wooed	wuz	wud
effect	effected	IfEkt	IfEktId
seeps	seeped	sips	sipt
sideslip	sideslipped	s2dslIp	s2dslIpt
cartwheel	cartwheeled	k#twil	k#twild
find	found	f2nd	f6nd
garner	garnered	g#n@R	g#n@d
derate	derated	"dir1t	"dir1tId
resume	resumed	rIzjum	rIzjumd
retire	retired	rIt2@R	rIt2@d
celebrates	celebrated	sElIbr1ts	sElIbr1tId
narrate	narrated	n@r1t	n@r1tId
correlates	correlated	kQr@l1ts	kQr@l1tId
dunk	dunked	dVNk	dVNkt
display	displayed	dIspl1	dIspl1d
fizz	fizzed	fIz	fIzd
displays	displayed	dIspl1z	dIspl1d
lynches	lynched	lInJIz	lInJt
stage	staged	st1_	st1_d
taint	tainted	t1nt	t1ntId
thwacks	thwacked	Tw{ks	Tw{kt
wings	winged	wINz	wINd
equals	equalled	ikw@lz	ikw@ld
shake	shook	S1k	SUk
votes	voted	v5ts	v5tId
sketch	sketched	skEJ	skEJt
mop	mopped	mQp	mQpt
oxygenize	oxygenized	QksI_@n2z	QksI_@n2zd
filch	filched	fIlJ	fIlJt
entitle	entitled	Int2tP	Int2tPd
enounces	enounced	in6nsIz	in6nst
distrusts	distrusted	dIstrVsts	dIstrVstId
lapses	lapsed	l{psIz	l{pst
counterfeits	counterfeited	k6nt@fIts	k6nt@fItId
superabound	superabounded	"sup@r@b6nd	"sup@r@b6ndId
demands	demanded	dIm#ndz	dIm#ndId
lends	lent	lEndz	lEnt
hurdle	hurdled	h3dP	h3dPd
skedaddle	skedaddled	skId{dP	skId{dPd
hint	hinted	hInt	hIntId
groove	grooved	gruv	gruvd
federates	federated	fEd@r1ts	fEd@r1tId
offers	offered	Qf@z	Qf@d
dare	dared	d8R	d8d
shudders	shuddered	SVd@z	SVd@d
defrauds	defrauded	dIfr$dz	dIfr$dId
preachify	preachified	priJIf2	priJIf2d
suppose	supposed	s@p5z	s@p5zd
pull	pulled	pUl	pUld
distrust	distrusted	dIstrVst	dIstrVstId
inserts	inserted	Ins3ts	Ins3tId
winch	winched	wInJ	wInJt
wenches	wenched	wEnJIz	wEnJt
mooches	mooched	muJIz	muJt
follow	followed	fQl5	fQl5d
forbid	forbid	f@bId	f@bId
fumigate	fumigated	fjumIg1t	fjumIg1tId
roost	roosted	rust	rustId
aspires	aspired	@sp2@z	@sp2@d
hedgehops	hedgehopped	hE_hQps	hE_hQpt
dilly-dallies	dilly-dallied	dIlI"d{lIz	dIlI"d{lId
reveals	revealed	rIvilz	rIvild
tenders	tendered	tEnd@z	tEnd@d
exceed	exceeded	Iksid	IksidId
fell	felled	fEl	fEld
preconceive	preconceived	"prik@nsiv	"prik@nsivd
pounds	pounded	p6ndz	p6ndId
sparkles	sparkled	sp#kPz	sp#kPd
unloads	unloaded	"Vnl5dz	"Vnl5dId
maintains	maintained	m1nt1nz	m1nt1nd
jostle	jostled	_QsP	_QsPd
wipes	wiped	w2ps	w2pt
pines	pined	p2nz	p2nd
prinks	prinked	prINks	prINkt
satisfy	satisfied	s{tIsf2	s{tIsf2d
amputates	amputated	{mpjUt1ts	{mpjUt1tId
trouble	troubled	trVbP	trVbPd
greet	greeted	grit	gritId
remainders	remaindered	rIm1nd@z	rIm1nd@d
praises	praised	pr1zIz	pr1zd
rebuilds	rebuilt	"ribIldz	"ribIlt
overplays	overplayed	"5v@pl1z	"5v@pl1d
dive	dove	d2v	d5v
ruck	rucked	rVk	rVkt
amass	amassed	@m{s	@m{st
raises	raised	r1zIz	r1zd
juggles	juggled	_VgPz	_VgPd
rationalizes	rationalized	r{SH@l2zIz	r{SH@l2zd
depute	deputed	dIpjut	dIpjutId
recapture	recaptured	"rik{pJ@R	"rik{pJ@d
forswear	forswore	f$sw8R	f$sw$R
forecasts	forecast	f$k#sts	f$k#st
lures	lured	l9z	l9d
rescue	rescued	rEskju	rEskjud
hear	heard	h7R	h3d
ponder	pondered	pQnd@R	pQnd@d
corresponds	corresponded	"kQrIspQndz	"kQrIspQndId
meet	met	mit	mEt
obtain	obtained	@bt1n	@bt1nd
runs	ran	rVnz	r{n
compensate	compensated	kQmpEns1t	kQmpEns1tId
paints	painted	p1nts	p1ntId
deplanes	deplaned	"dipl1nz	"dipl1nd
designate	designated	dEzIgn1t	dEzIgn1tId
spins	spun	spInz	spVn
fund	funded	fVnd	fVndId
prevaricate	prevaricated	prIv{rIk1t	prIv{rIk1tId
reunites	reunited	"rijun2ts	"rijun2tId
indenture	indentured	IndEnJ@R	IndEnJ@d
machines	machined	m@Sinz	m@Sind
obligates	obligated	QblIg1ts	QblIg1tId
centralize	centralized	sEntr@l2z	sEntr@l2zd
moves	moved	muvz	muvd
outtalks	outtalked	"6tt$ks	"6tt$kt
haze	hazed	h1z	h1zd
implement	implemented	ImplImEnt	ImplImEntId
stumbles	stumbled	stVmbPz	stVmbPd
overcomes	overcame	"5v@kVmz	"5v@k1m
parts	parted	p#ts	p#tId
blazons	blazoned	bl1zHz	bl1zHd
defrost	defrosted	"difrQst	"difrQstId
preclude	precluded	prIklud	prIkludId
mummify	mummified	mVmIf2	mVmIf2d
inquires	inquired	Inkw2@z	Inkw2@d
contrast	contrasted	k@ntr#st	k@ntr#stId
forebodes	foreboded	f$b5dz	f$b5dId
enable	enabled	In1bP	In1bPd
court	courted	k$t	k$tId
dwells	dwelt	dwElz	dwElt
pine	pined	p2n	p2nd
velarize	velarized	vil@r2z	vil@r2zd
contorts	contorted	k@nt$ts	k@nt$tId
corrupt	corrupted	k@rVpt	k@rVptId
ingrains	ingrained	"Ingr1nz	"Ingr1nd
utilizes	utilized	jut@l2zIz	jut@l2zd
rejoices	rejoiced	rI_4sIz	rI_4st
gibes	gibed	_2bz	_2bd
pinnacles	pinnacled	pIn@kPz	pIn@kPd
decompresses	decompressed	"dik@mprEsIz	"dik@mprEst
disappear	disappeared	"dIs@p7R	"dIs@p7d
adduces	adduced	@djusIz	@djust
extracts	extracted	Ikstr{kts	Ikstr{ktId
modify	modified	mQdIf2	mQdIf2d
welcome	welcomed	wElk@m	wElk@md
wills	would	wIlz	wUd
re-covers	re-covered	"rikVv@z	"rikVv@d
addle	addled	{dP	{dPd
lurk	lurked	l3k	l3kt
methylate	methylated	mET@l1t	mET@l1tId
sentimentalize	sentimentalized	"sEntImEntP2z	"sEntImEntP2zd
cripple	crippled	krIpP	krIpPd
bethinks	bethought	bITINks	bIT$t
implicate	implicated	ImplIk1t	ImplIk1tId
quarry	quarried	kwQrI	kwQrId
manoeuvre	manoeuvred	m@nuv@R	m@nuv@d
tenant	tenanted	tEn@nt	tEn@ntId
adduce	adduced	@djus	@djust
renounces	renounced	rIn6nsIz	rIn6nst
chastise	chastised	J{st2z	J{st2zd
twinkle	twinkled	twINkP	twINkPd
censor	censored	sEns@R	sEns@d
size	sized	s2z	s2zd
depose	deposed	dIp5z	dIp5zd
declines	declined	dIkl2nz	dIkl2nd
furnishes	furnished	f3nISIz	f3nISt
revamps	revamped	riv{mps	riv{mpt
motors	motored	m5t@z	m5t@d
switches	switched	swIJIz	swIJt
codes	coded	k5dz	k5dId
pretends	pretended	prItEndz	prItEndId
spout	spouted	sp6t	sp6tId
derates	derated	"dir1ts	"dir1tId
masters	mastered	m#st@z	m#st@d
flow	flowed	fl5	fl5d
crooks	crooked	krUks	krUkt
proposes	proposed	pr@p5zIz	pr@p5zd
types	typed	t2ps	t2pt
confer	conferred	k@nf3R	k@nf3d
crash-lands	crash-landed	kr{Sl{ndz	kr{Sl{ndId
sample	sampled	s#mpP	s#mpPd
bellow	bellowed	bEl5	bEl5d
riposte	riposted	rIpQst	rIpQstId
baby-sits	baby-sat	b1bI"sIts	b1bI"s{t
equalize	equalized	ikw@l2z	ikw@l2zd
load	loaded	l5d	l5dId
battles	battled	b{tPz	b{tPd
gibe	gibed	_2b	_2bd
flourish	flourished	flVrIS	flVrISt
cooperate	cooperated	k5Qp@r1t	k5Qp@r1tId
overcapitalizes	overcapitalized	"5v@k{pIt@l2zIz	"5v@k{pIt@l2zd
acquires	acquired	@kw2@z	@kw2@d
flash	flashed	fl{S	fl{St
stultify	stultified	stVltIf2	stVltIf2d
fights	fought	f2ts	f$t
reaches	reached	riJIz	riJt
prevails	prevailed	prIv1lz	prIv1ld
exports	exported	Iksp$ts	Iksp$tId
emulate	emulated	EmjUl1t	EmjUl1tId
support	supported	s@p$t	s@p$tId
replenish	replenished	rIplEnIS	rIplEnISt
intensify	intensified	IntEnsIf2	IntEnsIf2d
speeds	speeded	spidz	spidId
roasts	roasted	r5sts	r5stId
mate	mated	m1t	m1tId
beds	bedded	bEdz	bEdId
devours	devoured	dIv6@z	dIv6@d
secularize	secularized	sEkjUl@r2z	sEkjUl@r2zd
annotate	annotated	{n5t1t	{n5t1tId
fumes	fumed	fjumz	fjumd
emulates	emulated	EmjUl1ts	EmjUl1tId
render	rendered	rEnd@R	rEnd@d
scythes	scythed	s2Dz	s2Dd
cow	cowed	k6	k6d
bellows	bellowed	bEl5z	bEl5d
lengthen	lengthened	lENT@n	lENT@nd
marks	marked	m#ks	m#kt
separates	separated	sEp@r1ts	sEp@r1tId
traffic	trafficked	tr{fIk	tr{fIkt
provokes	provoked	pr@v5ks	pr@v5kt
skip	skipped	skIp	skIpt
constitute	constituted	kQnstItjut	kQnstItjutId
syllabifies	syllabified	sIl{bIf2z	sIl{bIf2d
create	created	kri1t	kri1tId
theorizes	theorized	T7r2zIz	T7r2zd
perfect	perfected	p@fEkt	p@fEktId
stirs	stirred	st3z	st3d
flick	flicked	flIk	flIkt
chops	chopped	JQps	JQpt
impose	imposed	Imp5z	Imp5zd
level	levelled	lEvP	lEvPd
buys	bought	b2z	b$t
chronicles	chronicled	krQnIkPz	krQnIkPd
article	articled	#tIkP	#tIkPd
reduces	reduced	rIdjusIz	rIdjust
hints	hinted	hInts	hIntId
rouse	roused	r6z	r6zd
supplants	supplanted	s@pl#nts	s@pl#ntId
alter	altered	$lt@R	$lt@d
enlist	enlisted	InlIst	InlIstId
release	released	rIlis	rIlist
conveys	conveyed	k@nv1z	k@nv1d
accelerate	accelerated	@ksEl@r1t	@ksEl@r1tId
certificate	certificated	s@tIfIk1t	s@tIfIk1tId
groin	groined	gr4n	gr4nd
sideslips	sideslipped	s2dslIps	s2dslIpt
characterizes	characterized	k{r@kt@r2zIz	k{r@kt@r2zd
hector	hectored	hEkt@R	hEkt@d
revive	revived	rIv2v	rIv2vd
boss	bossed	bQs	bQst
blocks	blocked	blQks	blQkt
contracts	contracted	k@ntr{kts	k@ntr{ktId
crimsons	crimsoned	krImzHz	krImzHd
pettifogs	pettifogged	pEtIfQgz	pEtIfQgd
jettisons	jettisoned	_EtIsHz	_EtIsHd
hock	hocked	hQk	hQkt
parody	parodied	p{r@dI	p{r@dId
invite	invited	Inv2t	Inv2tId
documents	documented	dQkjUmEnts	dQkjUmEntId
vivifies	vivified	vIvIf2z	vIvIf2d
mums	mummed	mVmz	mVmd
crimp	crimped	krImp	krImpt
slump	slumped	slVmp	slVmpt
quarries	quarried	kwQrIz	kwQrId
hazards	hazarded	h{z@dz	h{z@dId
travesties	travestied	tr{v@stIz	tr{v@stId
mimics	mimicked	mImIks	mImIkt
billows	billowed	bIl5z	bIl5d
bakes	baked	b1ks	b1kt
lasso	lassoed	l{su	l{sud
dumps	dumped	dVmps	dVmpt
two-times	two-timed	tut2mz	tut2md
slides	slid	sl2dz	slId
tilt	tilted	tIlt	tIltId
spellbinds	spellbound	spElb2ndz	spElb6nd
fazes	fazed	f1zIz	f1zd
belongs	belonged	bIlQNz	bIlQNd
outpoint	outpointed	6tp4nt	6tp4ntId
deplores	deplored	dIpl$z	dIpl$d
field-tests	field-tested	fildtEsts	fildtEstId
erase	erased	Ir1z	Ir1zd
corrupts	corrupted	k@rVpts	k@rVptId
assaults	assaulted	@s$lts	@s$ltId
acknowledge	acknowledged	@knQlI_	@knQlI_d
authorize	authorized	$T@r2z	$T@r2zd
reveal	revealed	rIvil	rIvild
woo	wooed	wu	wud
intensifies	intensified	IntEnsIf2z	IntEnsIf2d
fixates	fixated	fIks1ts	fIks1tId
dump	dumped	dVmp	dVmpt
appears	appeared	@p7z	@p7d
moans	moaned	m5nz	m5nd
bargain	bargained	b#gIn	b#gInd
licks	licked	lIks	lIkt
co-ordinate	co-ordinated	k5$dIn1t	k5$dIn1tId
cinch	cinched	sInJ	sInJt
typify	typified	tIpIf2	tIpIf2d
cultivate	cultivated	kVltIv1t	kVltIv1tId
extends	extended	IkstEndz	IkstEndId
whacks	whacked	w{ks	w{kt
revitalizes	revitalized	"riv2t@l2zIz	"riv2t@l2zd
ranges	ranged	r1n_Iz	r1n_d
scoop	scooped	skup	skupt
attach	attached	@t{J	@t{Jt
debates	debated	dIb1ts	dIb1tId
duns	dunned	dVnz	dVnd
tranquillize	tranquillized	tr{NkwIl2z	tr{NkwIl2zd
sells	sold	sElz	s5ld
trump	trumped	trVmp	trVmpt
follows	followed	fQl5z	fQl5d
rustproof	rustproofed	rVstpruf	rVstpruft
reforest	reforested	rifQrIst	rifQrIstId
enamour	enamoured	In{m@R	In{m@d
clangs	clanged	kl{Nz	kl{Nd
evict	evicted	IvIkt	IvIktId
complicate	complicated	kQmplIk1t	kQmplIk1tId
ban	banned	b{n	b{nd
phases	phased	f1zIz	f1zd
burn	burnt	b3n	b3nt
fits	fit	fIts	fIt
unwinds	unwound	"Vnw2ndz	"Vnw6nd
loathe	loathed	l5D	l5Dd
harangue	harangued	h@r{N	h@r{Nd
roofs	roofed	rufs	ruft
murders	murdered	m3d@z	m3d@d
bail	bailed	b1l	b1ld
transmigrates	transmigrated	"tr{nzm2gr1ts	"tr{nzm2gr1tId
burgles	burgled	b3gPz	b3gPd
feather	feathered	fED@R	fED@d
intermit	intermitted	"Int@mIt	"Int@mItId
abides	abode	@b2dz	@b5d
convolves	convolved	k@nvQlvz	k@nvQlvd
mastermind	masterminded	m#st@m2nd	m#st@m2ndId
squawks	squawked	skw$ks	skw$kt
isolate	isolated	2s@l1t	2s@l1tId
botanizes	botanized	bQt@n2zIz	bQt@n2zd
judges	judged	_V_Iz	_V_d
traduce	traduced	tr@djus	tr@djust
circumvent	circumvented	"s3k@mvEnt	"s3k@mvEntId
laces	laced	l1sIz	l1st
reorganizes	reorganized	"ri$g@n2zIz	"ri$g@n2zd
underacts	underacted	"Vnd@r{kts	"Vnd@r{ktId
deep-freeze	deep-froze	"dipfriz	"dipfr5z
listen	listened	lIsH	lIsHd
crook	crooked	krUk	krUkt
muster	mustered	mVst@R	mVst@d
exhilarates	exhilarated	IgzIl@r1ts	IgzIl@r1tId
crate	crated	kr1t	kr1tId
execrate	execrated	EksIkr1t	EksIkr1tId
screws	screwed	skruz	skrud
outbids	outbid	"6tbIdz	"6tbId
paws	pawed	p$z	p$d
bowls	bowled	b5lz	b5ld
decreases	decreased	dikrisIz	dikrist
extemporize	extemporized	IkstEmp@r2z	IkstEmp@r2zd
contort	contorted	k@nt$t	k@nt$tId
supposes	supposed	s@p5zIz	s@p5zd
skedaddles	skedaddled	skId{dPz	skId{dPd
save	saved	s1v	s1vd
marries	married	m{rIz	m{rId
beholds	beheld	bIh5ldz	bIhEld
funk	funked	fVNk	fVNkt
shamble	shambled	S{mbP	S{mbPd
drinks	drunk	drINks	drVNk
refresh	refreshed	rIfrES	rIfrESt
wages	waged	w1_Iz	w1_d
combats	combatted	kQmb{ts	kQmb{tId
spring	sprung	sprIN	sprVN
brain	brained	br1n	br1nd
presume	presumed	prIzjum	prIzjumd
tie-dyes	tie-dyed	t2d2z	t2d2d
need	needed	nid	nidId
writes	wrote	r2ts	r5t
memorializes	memorialized	m@m$r7l2zIz	m@m$r7l2zd
muffles	muffled	mVfPz	mVfPd
dart	darted	d#t	d#tId
retools	retooled	"ritulz	"rituld
rams	rammed	r{mz	r{md
railroad	railroaded	r1lr5d	r1lr5dId
scoops	scooped	skups	skupt
accommodate	accommodated	@kQm@d1t	@kQm@d1tId
fags	fagged	f{gz	f{gd
parodies	parodied	p{r@dIz	p{r@dId
tackle	tackled	t{kP	t{kPd
field-test	field-tested	fildtEst	fildtEstId
superintend	superintended	"sup@rIntEnd	"sup@rIntEndId
diffract	diffracted	dIfr{kt	dIfr{ktId
proves	proved	pruvz	pruvd
disturbs	disturbed	dIst3bz	dIst3bd
hobbles	hobbled	hQbPz	hQbPd
spends	spent	spEndz	spEnt
upend	upended	VpEnd	VpEndId
desegregates	desegregated	"disEgrIg1ts	"disEgrIg1tId
misname	misnamed	"mIsn1m	"mIsn1md
upend	upended	VpEnd	VpEndId
endangers	endangered	Ind1n_@z	Ind1n_@d
debauches	debauched	dIb$JIz	dIb$Jt
scribe	scribed	skr2b	skr2bd
breaks	broke	br1ks	br5k
brings	brought	brINz	br$t
drudge	drudged	drV_	drV_d
exult	exulted	IgzVlt	IgzVltId
swot	swotted	swQt	swQtId
revitalize	revitalized	"riv2t@l2z	"riv2t@l2zd
distends	distended	dIstEndz	dIstEndId
co-star	co-starred	k5st#R	k5st#d
translate	translated	tr{nsl1t	tr{nsl1tId
bumps	bumped	bVmps	bVmpt
write	wrote	r2t	r5t
issue	issued	ISu	ISud
circumcise	circumcised	s3k@ms2z	s3k@ms2zd
intrigue	intrigued	Intrig	Intrigd
prim	primmed	prIm	prImd
fluster	flustered	flVst@R	flVst@d
resinates	resinated	rEsI"n1ts	rEsI"n1tId
prognosticates	prognosticated	prQgnQstIk1ts	prQgnQstIk1tId
overtrump	overtrumped	"5v@trVmp	"5v@trVmpt
recur	recurred	rIk3R	rIk3d
strike	struck	str2k	strVk
cows	cowed	k6z	k6d
bothers	bothered	bQD@z	bQD@d
ensconce	ensconced	InskQns	InskQnst
collars	collared	kQl@z	kQl@d
enjoins	enjoined	In_4nz	In_4nd
planks	planked	pl{Nks	pl{Nkt
adjourn	adjourned	@_3n	@_3nd
countermands	countermanded	"k6nt@m#ndz	"k6nt@m#ndId
wield	wielded	wild	wildId
conduct	conducted	k@ndVkt	k@ndVktId
regiment	regimented	rE_ImEnt	rE_ImEntId
conflict	conflicted	k@nflIkt	k@nflIktId
complete	completed	k@mplit	k@mplitId
microfilm	microfilmed	m2kr5fIlm	m2kr5fIlmd
shelter	sheltered	SElt@R	SElt@d
throws	threw	Tr5z	Tru
topple	toppled	tQpP	tQpPd
lofts	lofted	lQfts	lQftId
discourage	discouraged	dIskVrI_	dIskVrI_d
burgeon	burgeoned	b3_@n	b3_@nd
short-change	short-changed	"S$tJ1n_	"S$tJ1n_d
cleans	cleaned	klinz	klind
broadcasts	broadcast	br$dk#sts	br$dk#st
sellotape	sellotaped	sEl5t1p	sEl5t1pt
bore	bored	b$R	b$d
darts	darted	d#ts	d#tId
hallmarks	hallmarked	h$lm#ks	h$lm#kt
afforests	afforested	{fQrIsts	{fQrIstId
incorporate	incorporated	Ink$p@r1t	Ink$p@r1tId
envisage	envisaged	InvIzI_	InvIzI_d
hazard	hazarded	h{z@d	h{z@dId
bungs	bunged	bVNz	bVNd
comes	came	kVmz	k1m
gel	gelled	_El	_Eld
probate	probated	pr5b1t	pr5b1tId
affords	afforded	@f$dz	@f$dId
assay	assayed	@s1	@s1d
backs	backed	b{ks	b{kt
fork	forked	f$k	f$kt
laves	laved	l1vz	l1vd
feature	featured	fiJ@R	fiJ@d
notates	notated	n5t1ts	n5t1tId
syncopates	syncopated	sINk@p1ts	sINk@p1tId
proclaim	proclaimed	pr@kl1m	pr@kl1md
tick	ticked	tIk	tIkt
belittles	belittled	bIlItPz	bIlItPd
sit	sat	sIt	s{t
attires	attired	@t2@z	@t2@d
sows	sowed	s5z	s5d
cure	cured	kj9R	kj9d
pinnacle	pinnacled	pIn@kP	pIn@kPd
encourage	encouraged	InkVrI_	InkVrI_d
charts	charted	J#ts	J#tId
compartmentalize	compartmentalized	"kQmp#tmEntP2z	"kQmp#tmEntP2zd
rambles	rambled	r{mbPz	r{mbPd
reflect	reflected	rIflEkt	rIflEktId
gasses	gassed	g{sIz	g{st
normalizes	normalized	n$m@l2zIz	n$m@l2zd
kotows	kotowed	"k5t6z	"k5t6d
tipple	tippled	tIpP	tIpPd
sloshes	sloshed	slQSIz	slQSt
reorient	reoriented	ri$r7nt	ri$r7ntId
contact	contacted	kQnt{kt	kQnt{ktId
cheers	cheered	J7z	J7d
pause	paused	p$z	p$zd
stumps	stumped	stVmps	stVmpt
belittle	belittled	bIlItP	bIlItPd
gazumps	gazumped	g@zVmps	g@zVmpt
underestimates	underestimated	"Vnd@rEstIm1ts	"Vnd@rEstIm1tId
plank	planked	pl{Nk	pl{Nkt
points	pointed	p4nts	p4ntId
exert	exerted	Igz3t	Igz3tId
embraces	embraced	Imbr1sIz	Imbr1st
evoke	evoked	Iv5k	Iv5kt
iodizes	iodized	25d2zIz	25d2zd
frequents	frequented	frIkwEnts	frIkwEntId
rob	robbed	rQb	rQbd
deal	dealt	dil	dElt
adventure	adventured	@dvEnJ@R	@dvEnJ@d
pacify	pacified	p{sIf2	p{sIf2d
focus	focussed	f5k@s	f5k@st
bails	bailed	b1lz	b1ld
bull	bulled	bUl	bUld
co-stars	co-starred	k5st#z	k5st#d
determine	determined	dIt3mIn	dIt3mInd
brush	brushed	brVS	brVSt
tax	taxed	t{ks	t{kst
fog	fogged	fQg	fQgd
slugs	slugged	slVgz	slVgd
peels	peeled	pilz	pild
whales	whaled	w1lz	w1ld
demonstrates	demonstrated	dEm@nstr1ts	dEm@nstr1tId
crops	cropped	krQps	krQpt
finances	financed	f2n{nsIz	f2n{nst
chauffeurs	chauffeured	S5f@z	S5f@d
undresses	undressed	"VndrEsIz	"VndrEst
avert	averted	@v3t	@v3tId
bedew	bedewed	bIdju	bIdjud
manure	manured	m@nj9R	m@nj9d
jeopardizes	jeopardized	_Ep@d2zIz	_Ep@d2zd
hectors	hectored	hEkt@z	hEkt@d
reprieve	reprieved	rIpriv	rIprivd
sops	sopped	sQps	sQpt
amputate	amputated	{mpjUt1t	{mpjUt1tId
states	stated	st1ts	st1tId
diets	dieted	d2@ts	d2@tId
barges	barged	b#_Iz	b#_d
bicycles	bicycled	b2sIkPz	b2sIkPd
harnesses	harnessed	h#nIsIz	h#nIst
stare	stared	st8R	st8d
xerox	xeroxed	z7rQks	z7rQkst
counteracts	counteracted	"k6nt@r{kts	"k6nt@r{ktId
tells	told	tElz	t5ld
condemns	condemned	k@ndEmz	k@ndEmd
wades	waded	w1dz	w1dId
bikes	biked	b2ks	b2kt
streak	streaked	strik	strikt
fulfils	fulfilled	fUlfIlz	fUlfIld
wonder	wondered	wVnd@R	wVnd@d
constructs	constructed	k@nstrVkts	k@nstrVktId
banks	banked	b{Nks	b{Nkt
dissolves	dissolved	dIzQlvz	dIzQlvd
escalate	escalated	Esk@l1t	Esk@l1tId
butter	buttered	bVt@R	bVt@d
fells	felled	fElz	fEld
smooths	smoothed	smuDz	smuDd
speed	speeded	spid	spidId
forgo	forwent	f$g5	f$wEnt
bed	bedded	bEd	bEdId
move	moved	muv	muvd
lapse	lapsed	l{ps	l{pst
cheats	cheated	Jits	JitId
summers	summered	sVm@z	sVm@d
play	played	pl1	pl1d
jinxes	jinxed	_INksIz	_INkst
interrupts	interrupted	"Int@rVpts	"Int@rVptId
measures	measured	mEZ@z	mEZ@d
serve	served	s3v	s3vd
bash	bashed	b{S	b{St
brainwashes	brainwashed	br1nwQSIz	br1nwQSt
imposes	imposed	Imp5zIz	Imp5zd
complain	complained	k@mpl1n	k@mpl1nd
surmises	surmised	s3m2zIz	s3m2zd
destruct	destructed	dIstrVkt	dIstrVktId
pop	popped	pQp	pQpt
host	hosted	h5st	h5stId
die	died	d2	d2d
giggle	giggled	gIgP	gIgPd
censures	censured	sEnS@z	sEnS@d
triggers	triggered	trIg@z	trIg@d
return	returned	rIt3n	rIt3nd
compounds	compounded	k@mp6ndz	k@mp6ndId
slenderize	slenderized	slEnd@r2z	slEnd@r2zd
factor	factored	f{kt@R	f{kt@d
protects	protected	pr@tEkts	pr@tEktId
bend	bent	bEnd	bEnt
arbitrates	arbitrated	#bItr1ts	#bItr1tId
subsume	subsumed	s@bsjum	s@bsjumd
supervise	supervised	sup@v2z	sup@v2zd
allies	allied	@l2z	@l2d
project	projected	pr@_Ekt	pr@_EktId
instigate	instigated	InstIg1t	InstIg1tId
blue	blued	blu	blud
plonks	plonked	plQNks	plQNkt
enjoy	enjoyed	In_4	In_4d
photostat	photostatted	f5t5st{t	f5t5st{tId
details	detailed	dit1lz	dit1ld
liberates	liberated	lIb@r1ts	lIb@r1tId
exploit	exploited	Ikspl4t	Ikspl4tId
hocks	hocked	hQks	hQkt
hops	hopped	hQps	hQpt
prearranges	prearranged	"pri@r1n_Iz	"pri@r1n_d
asks	asked	#sks	#skt
wants	wanted	wQnts	wQntId
meshes	meshed	mESIz	mESt
endanger	endangered	Ind1n_@R	Ind1n_@d
maps	mapped	m{ps	m{pt
kisses	kissed	kIsIz	kIst
pancakes	pancaked	p{Nk1ks	p{Nk1kt
advise	advised	@dv2z	@dv2zd
relive	relived	"rilIv	"rilIvd
corn	corned	k$n	k$nd
catch	caught	k{J	k$t
dropkicks	dropkicked	drQp"kIks	drQp"kIkt
ravages	ravaged	r{vI_Iz	r{vI_d
audit	audited	$dIt	$dItId
launch	launched	l$nJ	l$nJt
shun	shunned	SVn	SVnd
tamp	tamped	t{mp	t{mpt
select	selected	sIlEkt	sIlEktId
flail	flailed	fl1l	fl1ld
flicks	flicked	flIks	flIkt
mend	mended	mEnd	mEndId
nail	nailed	n1l	n1ld
administers	administered	@dmInIst@z	@dmInIst@d
scraps	scrapped	skr{ps	skr{pt
foresee	foresaw	f$si	f$s$
can	could	k{n	kUd
enjoys	enjoyed	In_4z	In_4d
disembowel	disembowelled	"dIsImb6@l	"dIsImb6@ld
jolly	jollied	_QlI	_QlId
mutilate	mutilated	mjutIl1t	mjutIl1tId
hoax	hoaxed	h5ks	h5kst
understands	understood	"Vnd@st{ndz	"Vnd@stud
drink	drunk	drINk	drVNk
metricates	metricated	mEtrI"k1ts	mEtrI"k1tId
captures	captured	k{pJ@z	k{pJ@d
rubberize	rubberized	rVb@r2z	rVb@r2zd
illustrate	illustrated	Il@str1t	Il@str1tId
pickle	pickled	pIkP	pIkPd
relieves	relieved	rIlivz	rIlivd
flits	flitted	flIts	flItId
forswears	forswore	f$sw8z	f$sw$R
praise	praised	pr1z	pr1zd
prosecute	prosecuted	prQsIkjut	prQsIkjutId
stretch	stretched	strEJ	strEJt
belong	belonged	bIlQN	bIlQNd
replicates	replicated	rEplIk1ts	rEplIk1tId
gasses	gassed	g{sIz	g{st
ruck	rucked	rVk	rVkt
chance	chanced	J#ns	J#nst
satiates	satiated	s1SI1ts	s1SI1tId
roars	roared	r$z	r$d
underestimate	underestimated	"Vnd@rEstIm1t	"Vnd@rEstIm1tId
advocate	advocated	{dv@k1t	{dv@k1tId
blitz	blitzed	blIts	blItst
buckets	bucketed	bVkIts	bVkItId
minimizes	minimized	mInIm2zIz	mInIm2zd
flatter	flattered	fl{t@R	fl{t@d
sympathizes	sympathized	sImp@T2zIz	sImp@T2zd
flinch	flinched	flInJ	flInJt
inhabits	inhabited	Inh{bIts	Inh{bItId
place	placed	pl1s	pl1st
refloat	refloated	"rifl5t	"rifl5tId
chat	chatted	J{t	J{tId
sanctions	sanctioned	s{NkSHz	s{NkSHd
plate	plated	pl1t	pl1tId
threatens	threatened	TrEtHz	TrEtHd
descend	descended	dIsEnd	dIsEndId
arrests	arrested	@rEsts	@rEstId
compete	competed	k@mpit	k@mpitId
upset	upset	VpsEt	VpsEt
weep	wept	wip	wEpt
abhors	abhorred	@bh$z	@bh$d
breathalyse	breathalysed	brET@l2z	brET@l2zd
waive	waived	w1v	w1vd
envelop	enveloped	InvEl@p	InvEl@pt
retches	retched	rEJIz	rEJt
sing	sang	sIN	s{N
whisper	whispered	wIsp@R	wIsp@d
cites	cited	s2ts	s2tId
foxes	foxed	fQksIz	fQkst
levitates	levitated	lEvIt1ts	lEvIt1tId
minimize	minimized	mInIm2z	mInIm2zd
discredit	discredited	dIskrEdIt	dIskrEdItId
remilitarize	remilitarized	"rimIlIt@r2z	"rimIlIt@r2zd
cleave	clove	kliv	kl5v
calcines	calcined	k{ls2nz	k{ls2nd
vents	vented	vEnts	vEntId
ride	rode	r2d	r5d
busks	busked	bVsks	bVskt
iron	ironed	2@n	2@nd
disjoints	disjointed	dIs_4nts	dIs_4ntId
hide	hid	h2d	hId
gawps	gawped	g$ps	g$pt
refuses	refused	rIfjuzIz	rIfjuzd
lathers	lathered	l#D@z	l#D@d
pitchforks	pitchforked	pIJf$ks	pIJf$kt
flee	fled	fli	flEd
unlearn	unlearned	"Vnl3n	"Vnl3nd
breathes	breathed	briDz	briDd
scramble	scrambled	skr{mbP	skr{mbPd
doubts	doubted	d6ts	d6tId
cinches	cinched	sInJIz	sInJt
rages	raged	r1_Iz	r1_d
read	read	rEd	rEd
gas	gassed	g{s	g{st
primp	primped	prImp	prImpt
arm	armed	#m	#md
slug	slugged	slVg	slVgd
canvass	canvassed	k{nv@s	k{nv@st
embarrasses	embarrassed	Imb{r@sIz	Imb{r@st
brawl	brawled	br$l	br$ld
telescope	telescoped	tElIsk5p	tElIsk5pt
shinny	shinnied	SInI	SInId
escarps	escarped	Isk#ps	Isk#pt
educes	educed	idjusIz	idjust
filter	filtered	fIlt@R	fIlt@d
devil	devilled	dEvP	dEvPd
dispel	dispelled	dIspEl	dIspEld
symbolize	symbolized	sImb@l2z	sImb@l2zd
disagrees	disagreed	"dIs@griz	"dIs@grid
window-shop	window-shopped	wInd5SQp	wInd5SQpt
sloshes	sloshed	slQSIz	slQSt
shutter	shuttered	SVt@R	SVt@d
turns	turned	t3nz	t3nd
alienates	alienated	1lj@n1ts	1lj@n1tId
impersonates	impersonated	Imp3s@n1ts	Imp3s@n1tId
tortures	tortured	t$J@z	t$J@d
acidulate	acidulated	@sIdjUl1t	@sIdjUl1tId
overhear	overheard	"5v@h7R	"5v@h3d
prearrange	prearranged	"pri@r1n_	"pri@r1n_d
progress	progressed	pr5grEs	pr5grEst
beseems	beseemed	bIsimz	bIsimd
sleet	sleeted	slit	slitId
dog	dogged	dQg	dQgd
soften	softened	sQfH	sQfHd
bottle-feeds	bottle-fed	bQtPfidz	bQtPfEd
forgets	forgot	f@gEts	f@gQt
perpetuates	perpetuated	p@pEJU1ts	p@pEJU1tId
revere	revered	rIv7R	rIv7d
scouts	scouted	sk6ts	sk6tId
steeps	steeped	stips	stipt
differentiates	differentiated	"dIf@rEnSI1ts	"dIf@rEnSI1tId
censor	censored	sEns@R	sEns@d
cross-questions	cross-questioned	"krQskwEsJ@nz	"krQskwEsJ@nd
gorges	gorged	g$_Iz	g$_d
omits	omitted	@mIts	@mItId
post	posted	p5st	p5stId
command	commanded	k@m#nd	k@m#ndId
restate	restated	"rist1t	"rist1tId
entraps	entrapped	Intr{ps	Intr{pt
babies	babied	b1bIz	b1bId
glows	glowed	gl5z	gl5d
suit	suited	sut	sutId
receipt	receipted	rIsit	rIsitId
mumbles	mumbled	mVmbPz	mVmbPd
addles	addled	{dPz	{dPd
export	exported	Iksp$t	Iksp$tId
trumps	trumped	trVmps	trVmpt
trumpets	trumpeted	trVmpIts	trVmpItId
misdemeans	misdemeaned	"mIsdIminz	"mIsdImind
renew	renewed	rInju	rInjud
denounce	denounced	dIn6ns	dIn6nst
graduates	graduated	gr{djU1ts	gr{djU1tId
advertise	advertised	{dv@t2z	{dv@t2zd
lofts	lofted	lQfts	lQftId
credits	credited	krEdIts	krEdItId
grant	granted	gr#nt	gr#ntId
mooch	mooched	muJ	muJt
envelops	enveloped	InvEl@ps	InvEl@pt
assays	assayed	@s1z	@s1d
imitate	imitated	ImIt1t	ImIt1tId
leave	left	liv	lEft
photostats	photostatted	f5t5st{ts	f5t5st{tId
damage	damaged	d{mI_	d{mI_d
contaminate	contaminated	k@nt{mIn1t	k@nt{mIn1tId
shuns	shunned	SVnz	SVnd
assures	assured	@S$z	@S$d
dispense	dispensed	dIspEns	dIspEnst
exercises	exercised	Eks@s2zIz	Eks@s2zd
glow	glowed	gl5	gl5d
mire	mired	m2@R	m2@d
pre-exists	pre-existed	"priIgzIsts	"priIgzIstId
extols	extolled	Ikst5lz	Ikst5ld
preconceive	preconceived	"prik@nsiv	"prik@nsivd
scrap	scrapped	skr{p	skr{pt
books	booked	bUks	bUkt
rejects	rejected	rI_Ekts	rI_EktId
accommodates	accommodated	@kQm@d1ts	@kQm@d1tId
salvages	salvaged	s{lvI_Iz	s{lvI_d
booby-trap	booby-trapped	bubItr{p	bubItr{pt
profile	profiled	pr5f2l	pr5f2ld
decant	decanted	dIk{nt	dIk{ntId
bunks	bunked	bVNks	bVNkt
peregrinate	peregrinated	pErIgrIn1t	pErIgrIn1tId
resembles	resembled	rIzEmbPz	rIzEmbPd
liaises	liaised	lI1zIz	lI1zd
doubles	doubled	dVbPz	dVbPd
expand	expanded	Iksp{nd	Iksp{ndId
places	placed	pl1sIz	pl1st
collapse	collapsed	k@l{ps	k@l{pst
appeals	appealed	@pilz	@pild
backbites	backbit	b{kb2ts	b{kbIt
decarbonizes	decarbonized	"dik#b@n2zIz	"dik#b@n2zd
attitudinizes	attitudinized	"{tItjudIn2zIz	"{tItjudIn2zd
burst	burst	b3st	b3st
deranges	deranged	dIr1n_Iz	dIr1n_d
hook	hooked	hUk	hUkt
federate	federated	fEd@r1t	fEd@r1tId
presides	presided	prIz2dz	prIz2dId
muss	mussed	mVs	mVst
hesitates	hesitated	hEzIt1ts	hEzIt1tId
passes	passed	p#sIz	p#st
straggle	straggled	str{gP	str{gPd
envy	envied	EnvI	EnvId
applies	applied	@pl2z	@pl2d
dandify	dandified	d{ndIf2	d{ndIf2d
whelp	whelped	wElp	wElpt
overpower	overpowered	"5v@p6@R	"5v@p6@d
climb	climbed	kl2m	kl2md
imitates	imitated	ImIt1ts	ImIt1tId
push	pushed	pUS	pUSt
appreciate	appreciated	@priSI1t	@priSI1tId
upends	upended	VpEndz	VpEndId
submit	submitted	s@bmIt	s@bmItId
tally	tallied	t{lI	t{lId
intrudes	intruded	Intrudz	IntrudId
readjust	readjusted	"ri@_Vst	"ri@_VstId
gain	gained	g1n	g1nd
lower	lowered	l5@R	l5@d
evokes	evoked	Iv5ks	Iv5kt
unrolls	unrolled	"Vnr5lz	"Vnr5ld
heartens	heartened	h#tHz	h#tHd
intrude	intruded	Intrud	IntrudId
fouls	fouled	f6lz	f6ld
wiggles	wiggled	wIgPz	wIgPd
infatuates	infatuated	Inf{tjU1ts	Inf{tjU1tId
roast	roasted	r5st	r5stId
lame	lamed	l1m	l1md
trip	tripped	trIp	trIpt
bleaches	bleached	bliJIz	bliJt
drips	dripped	drIps	drIpt
fill	filled	fIl	fIld
attend	attended	@tEnd	@tEndId
discloses	disclosed	dIskl5zIz	dIskl5zd
peregrinates	peregrinated	pErIgrIn1ts	pErIgrIn1tId
erects	erected	IrEkts	IrEktId
macerate	macerated	m{s@r1t	m{s@r1tId
avoid	avoided	@v4d	@v4dId
theorizes	theorized	T7r2zIz	T7r2zd
pings	pinged	pINz	pINd
diffract	diffracted	dIfr{kt	dIfr{ktId
crop	cropped	krQp	krQpt
cleanses	cleansed	klEnzIz	klEnzd
misunderstand	misunderstood	"mIsVnd@st{nd	"mIsVnd@stUd
adopt	adopted	@dQpt	@dQptId
talks	talked	t$ks	t$kt
bores	bored	b$z	b$d
sledge	sledged	slE_	slE_d
slurp	slurped	sl3p	sl3pt
camp	camped	k{mp	k{mpt
clutch	clutched	klVJ	klVJt
fields	fielded	fildz	fildId
materialize	materialized	m@t7r7l2z	m@t7r7l2zd
imply	implied	Impl2	Impl2d
overbalances	overbalanced	"5v@b{l@nsIz	"5v@b{l@nst
flurry	flurried	flVrI	flVrId
exercise	exercised	Eks@s2z	Eks@s2zd
forget	forgot	f@gEt	f@gQt
overtops	overtopped	"5v@tQps	"5v@tQpt
incurs	incurred	Ink3z	Ink3d
commemorate	commemorated	k@mEm@r1t	k@mEm@r1tId
relocate	relocated	"ril5k1t	"ril5k1tId
serves	served	s3vz	s3vd
arrogates	arrogated	{r5g1ts	{r5g1tId
bobsleigh	bobsleighed	bQbsl1	bQbsl1d
board	boarded	b$d	b$dId
outweigh	outweighed	"6tw1	"6tw1d
clocks	clocked	klQks	klQkt
reforests	reforested	rifQrIsts	rifQrIstId
require	required	rIkw2@R	rIkw2@d
cinches	cinched	sInJIz	sInJt
predigests	predigested	"prid2_Ests	"prid2_EstId
de-ice	de-iced	"di2s	"di2st
present	presented	prIzEnt	prIzEntId
practise	practised	pr{ktIs	pr{ktIst
distribute	distributed	dIstrIbjut	dIstrIbjutId
specializes	specialized	spES@l2zIz	spES@l2zd
identifies	identified	2dEntIf2z	2dEntIf2d
belts	belted	bElts	bEltId
test-drives	test-drove	tEstdr2vz	tEstdr5v
prink	prinked	prINk	prINkt
whirr	whirred	w3R	w3d
nosedives	nosedived	n5zd2vz	n5zd2vd
amplify	amplified	{mplIf2	{mplIf2d
dazzle	dazzled	d{zP	d{zPd
meddles	meddled	mEdPz	mEdPd
chastises	chastised	J{st2zIz	J{st2zd
bifurcate	bifurcated	b2f@k1t	b2f@k1tId
slackens	slackened	sl{k@nz	sl{k@nd
conjugates	conjugated	kQn_Ug1ts	kQn_Ug1tId
bucket	bucketed	bVkIt	bVkItId
rear	reared	r7R	r7d
undress	undressed	"VndrEs	"VndrEst
squint	squinted	skwInt	skwIntId
pass	passed	p#s	p#st
prejudices	prejudiced	prE_UdIsIz	prE_UdIst
warn	warned	w$n	w$nd
forbear	forbore	f$b8R	f$b$R
likes	liked	l2ks	l2kt
dashes	dashed	d{SIz	d{St
welds	welded	wEldz	wEldId
inconvenience	inconvenienced	"Ink@nvinj@ns	"Ink@nvinj@nst
cobbles	cobbled	kQbPz	kQbPd
witness	witnessed	wItnIs	wItnIst
tarmac	tarmacked	t#m{k	t#m{kt
interdicts	interdicted	"Int@dIkts	"Int@dIktId
dissatisfy	dissatisfied	"dIss{tIsf2	"dIss{tIsf2d
remilitarizes	remilitarized	"rimIlIt@r2zIz	"rimIlIt@r2zd
chug	chugged	JVg	JVgd
coats	coated	k5ts	k5tId
overtop	overtopped	"5v@tQp	"5v@tQpt
palls	palled	p$lz	p$ld
beeswax	beeswaxed	bizw{ks	bizw{kst
supplicate	supplicated	sVplIk1t	sVplIk1tId
suffice	sufficed	s@f2s	s@f2st
confirm	confirmed	k@nf3m	k@nf3md
behaves	behaved	bIh1vz	bIh1vd
flags	flagged	fl{gz	fl{gd
bulldozes	bulldozed	bUld5zIz	bUld5zd
transmogrifies	transmogrified	tr{nzmQgrIf2z	tr{nzmQgrIf2d
track	tracked	tr{k	tr{kt
accentuate	accentuated	{ksEntjU1t	{ksEntjU1tId
brawls	brawled	br$lz	br$ld
blacks	blacked	bl{ks	bl{kt
unlearns	unlearned	"Vnl3nz	"Vnl3nd
commingle	commingled	kQmINgP	kQmINgPd
bet	bet	bEt	bEt
handles	handled	h{ndPz	h{ndPd
recharges	recharged	"riJ#_Iz	"riJ#_d
reorients	reoriented	ri$r7nts	ri$r7ntId
escalates	escalated	Esk@l1ts	Esk@l1tId
oppugns	oppugned	@pjunz	@pjund
paves	paved	p1vz	p1vd
bury	buried	bErI	bErId
disentangle	disentangled	"dIsInt{NgP	"dIsInt{NgPd
sees	saw	siz	s$
wreck	wrecked	rEk	rEkt
soak	soaked	s5k	s5kt
houses	housed	h6zIz	h6zd
canvasses	canvassed	k{nv@sIz	k{nv@st
predominate	predominated	prIdQmIn1t	prIdQmIn1tId
pops	popped	pQps	pQpt
pontificates	pontificated	pQntIfIk1ts	pQntIfIk1tId
lessens	lessened	lEsHz	lEsHd
finance	financed	f2n{ns	f2n{nst
outpoints	outpointed	6tp4nts	6tp4ntId
negotiate	negotiated	nIg5SI1t	nIg5SI1tId
moan	moaned	m5n	m5nd
photographs	photographed	f5t@gr#fs	f5t@gr#ft
asserts	asserted	@s3ts	@s3tId
contradict	contradicted	"kQntr@dIkt	"kQntr@dIktId
perks	perked	p3ks	p3kt
scribe	scribed	skr2b	skr2bd
torture	tortured	t$J@R	t$J@d
terminate	terminated	t3mIn1t	t3mIn1tId
revitalizes	revitalized	"riv2t@l2zIz	"riv2t@l2zd
deflates	deflated	dIfl1ts	dIfl1tId
tie-dyes	tie-dyed	t2d2z	t2d2d
splotches	splotched	splQJIz	splQJt
bounce	bounced	b6ns	b6nst
tweaks	tweaked	twiks	twikt
reform	reformed	"rif$m	"rif$md
parleys	parleyed	p#lIz	p#lId
restrain	restrained	rIstr1n	rIstr1nd
tincture	tinctured	tINkJ@R	tINkJ@d
discredits	discredited	dIskrEdIts	dIskrEdItId
softens	softened	sQfHz	sQfHd
dropkick	dropkicked	drQp"kIk	drQp"kIkt
undertake	undertook	"Vnd@t1k	"Vnd@tuk
assemble	assembled	@sEmbP	@sEmbPd
calcine	calcined	k{ls2n	k{ls2nd
recreate	recreated	"rikri1t	"rikri1tId
mistime	mistimed	"mIst2m	"mIst2md
gossips	gossipped	gQsIps	gQsIpt
overcapitalize	overcapitalized	"5v@k{pIt@l2z	"5v@k{pIt@l2zd
shelters	sheltered	SElt@z	SElt@d
reproofs	reproofed	"riprufs	"ripruft
confide	confided	k@nf2d	k@nf2dId
folds	folded	f5ldz	f5ldId
undershoot	undershot	"Vnd@Sut	"Vnd@SQt
expands	expanded	Iksp{ndz	Iksp{ndId
curb	curbed	k3b	k3bd
cradle	cradled	kr1dP	kr1dPd
hoods	hooded	hUdz	hUdId
pressure	pressured	prES@R	prES@d
chain	chained	J1n	J1nd
brave	braved	br1v	br1vd
confers	conferred	k@nf3z	k@nf3d
jolts	jolted	_5lts	_5ltId
addles	addled	{dPz	{dPd
straitens	straitened	str1tHz	str1tHd
hosts	hosted	h5sts	h5stId
fears	feared	f7z	f7d
knock	knocked	nQk	nQkt
re-covers	re-covered	"rikVv@z	"rikVv@d
veneer	veneered	v@n7R	v@n7d
dispatch	dispatched	dIsp{J	dIsp{Jt
suffers	suffered	sVf@z	sVf@d
commits	committed	k@mIts	k@mItId
overhaul	overhauled	"5v@h$l	"5v@h$ld
care	cared	k8R	k8d
influence	influenced	Infl9ns	Infl9nst
recover	recovered	rIkVv@R	rIkVv@d
evangelize	evangelized	Iv{n_@l2z	Iv{n_@l2zd
start	started	st#t	st#tId
rears	reared	r7z	r7d
subdivide	subdivided	"sVbdIv2d	"sVbdIv2dId
bounces	bounced	b6nsIz	b6nst
censures	censured	sEnS@z	sEnS@d
crams	crammed	kr{mz	kr{md
stroke	stroked	str5k	str5kt
gets	got	gEts	gQt
intercalates	intercalated	Int3k@l1ts	Int3k@l1tId
ruts	rutted	rVts	rVtId
chips	chipped	JIps	JIpt
ping	pinged	pIN	pINd
trembles	trembled	trEmbPz	trEmbPd
tread	trod	trEd	trQd
orientate	orientated	$rIEnt1t	$rIEnt1tId
berth	berthed	b3T	b3Tt
marry	married	m{rI	m{rId
salaams	salaamed	s@l#mz	s@l#md
accentuate	accentuated	{ksEntjU1t	{ksEntjU1tId
exchange	exchanged	IksJ1n_	IksJ1n_d
proportions	proportioned	pr@p$SHz	pr@p$SHd
blackens	blackened	bl{k@nz	bl{k@nd
bevel	bevelled	bEvP	bEvPd
sting	stung	stIN	stVN
exploits	exploited	Ikspl4ts	Ikspl4tId
embark	embarked	Imb#k	Imb#kt
replace	replaced	rIpl1s	rIpl1st
petition	petitioned	p@tISH	p@tISHd
garners	garnered	g#n@z	g#n@d
hardens	hardened	h#dHz	h#dHd
tidies	tidied	t2dIz	t2dId
gloss	glossed	glQs	glQst
refloats	refloated	"rifl5ts	"rifl5tId
cuss	cussed	kVs	kVst
prosper	prospered	prQsp@R	prQsp@d
rage	raged	r1_	r1_d
presents	presented	prIzEnts	prIzEntId
benefice	beneficed	bEnIfIs	bEnIfIst
kid	kidded	kId	kIdId
brains	brained	br1nz	br1nd
mimeographs	mimeographed	mIm7gr#fs	mIm7gr#ft
berths	berthed	b3Ts	b3Tt
syllabify	syllabified	sIl{bIf2	sIl{bIf2d
romanticizes	romanticized	r5m{ntIs2zIz	r5m{ntIs2zd
gleam	gleamed	glim	glimd
resign	resigned	rIz2n	rIz2nd
cancel	cancelled	k{nsP	k{nsPd
intoxicates	intoxicated	IntQksIk1ts	IntQksIk1tId
table	tabled	t1bP	t1bPd
deserves	deserved	dIz3vz	dIz3vd
immure	immured	Imj9R	Imj9d
extract	extracted	Ikstr{kt	Ikstr{ktId
stipples	stippled	stIpPz	stIpPd
extrudes	extruded	Ikstrudz	IkstrudId
dreads	dreaded	drEdz	drEdId
mumble	mumbled	mVmbP	mVmbPd
precludes	precluded	prIkludz	prIkludId
scat	scatted	sk{t	sk{tId
master	mastered	m#st@R	m#st@d
puddles	puddled	pVdPz	pVdPd
storm	stormed	st$m	st$md
respect	respected	rIspEkt	rIspEktId
forestall	forestalled	f$st$l	f$st$ld
hurry	hurried	hVrI	hVrId
scatters	scattered	sk{t@z	sk{t@d
stipulates	stipulated	stIpjUl1ts	stIpjUl1tId
stings	stung	stINz	stVN
elucidate	elucidated	IlusId1t	IlusId1tId
chairs	chaired	J8z	J8d
ground	grounded	gr6nd	gr6ndId
ticket	ticketed	tIkIt	tIkItId
nibbles	nibbled	nIbPz	nIbPd
coincide	coincided	"k5Ins2d	"k5Ins2dId
tend	tended	tEnd	tEndId
limits	limited	lImIts	lImItId
obligate	obligated	QblIg1t	QblIg1tId
smacks	smacked	sm{ks	sm{kt
beseem	beseemed	bIsim	bIsimd
cossets	cosseted	kQsIts	kQsItId
stamps	stamped	st{mps	st{mpt
conciliate	conciliated	k@nsIlI1t	k@nsIlI1tId
revamps	revamped	riv{mps	riv{mpt
clams	clammed	kl{mz	kl{md
milk	milked	mIlk	mIlkt
humidify	humidified	hjumIdIf2	hjumIdIf2d
gaze	gazed	g1z	g1zd
yell	yelled	jEl	jEld
reword	reworded	"riw3d	"riw3dId
elude	eluded	Ilud	IludId
distrust	distrusted	dIstrVst	dIstrVstId
scan	scanned	sk{n	sk{nd
flavours	flavoured	fl1v@z	fl1v@d
exit	exited	EksIt	EksItId
remark	remarked	rIm#k	rIm#kt
pressure	pressured	prES@R	prES@d
respects	respected	rIspEkts	rIspEktId
cheapens	cheapened	Jip@nz	Jip@nd
ford	forded	f$d	f$dId
reserves	reserved	rIz3vz	rIz3vd
crusade	crusaded	krus1d	krus1dId
leach	leached	liJ	liJt
politicizes	politicized	p@lItIs2zIz	p@lItIs2zd
augurs	augured	$g@z	$g@d
packs	packed	p{ks	p{kt
retch	retched	rEJ	rEJt
terminates	terminated	t3mIn1ts	t3mIn1tId
stunt	stunted	stVnt	stVntId
recap	recapped	rik{p	rik{pt
gerrymanders	gerrymandered	_ErIm{nd@z	_ErIm{nd@d
involve	involved	InvQlv	InvQlvd
extemporizes	extemporized	IkstEmp@r2zIz	IkstEmp@r2zd
debate	debated	dIb1t	dIb1tId
believes	believed	bIlivz	bIlivd
manhandles	manhandled	m{n"h{ndPz	m{n"h{ndPd
iterate	iterated	It@r1t	It@r1tId
gambols	gambolled	g{mbPz	g{mbPd
catches	caught	k{JIz	k$t
manifests	manifested	m{nIfEsts	m{nIfEstId
believe	believed	bIliv	bIlivd
hesitate	hesitated	hEzIt1t	hEzIt1tId
stet	stetted	stEt	stEtId
agree	agreed	@gri	@grid
hang	hung	h{N	hVN
powders	powdered	p6d@z	p6d@d
stagger	staggered	st{g@R	st{g@d
slashes	slashed	sl{SIz	sl{St
instigates	instigated	InstIg1ts	InstIg1tId
wave	waved	w1v	w1vd
subserves	subserved	s@bs3vz	s@bs3vd
hallucinate	hallucinated	h@lusIn1t	h@lusIn1tId
stages	staged	st1_Iz	st1_d
comprehends	comprehended	"kQmprIhEndz	"kQmprIhEndId
imports	imported	Imp$ts	Imp$tId
beats	beat	bits	bit
cream	creamed	krim	krimd
entail	entailed	Int1l	Int1ld
bosses	bossed	bQsIz	bQst
effects	effected	IfEkts	IfEktId
grazes	grazed	gr1zIz	gr1zd
purpose	purposed	p3p@s	p3p@st
matures	matured	m@tj9z	m@tj9d
want	wanted	wQnt	wQntId
caw	cawed	k$	k$d
dishorns	dishorned	dIsh$nz	dIsh$nd
vends	vended	vEndz	vEndId
mention	mentioned	mEnSH	mEnSHd
confirms	confirmed	k@nf3mz	k@nf3md
seesaws	seesawed	sis$z	sis$d
scribbles	scribbled	skrIbPz	skrIbPd
harness	harnessed	h#nIs	h#nIst
change	changed	J1n_	J1n_d
sentimentalizes	sentimentalized	"sEntImEntP2zIz	"sEntImEntP2zd
farrow	farrowed	f{r5	f{r5d
shanghai	shanghaied	"S{Nh2	"S{Nh2d
engulfs	engulfed	IngVlfs	IngVlft
raft	rafted	r#ft	r#ftId
coshes	coshed	kQSIz	kQSt
validate	validated	v{lId1t	v{lId1tId
enplanes	enplaned	Inpl1nz	Inpl1nd
deliberates	deliberated	dIlIb@r1ts	dIlIb@r1tId
adventures	adventured	@dvEnJ@z	@dvEnJ@d
seeks	sought	siks	s$t
reflects	reflected	rIflEkts	rIflEktId
castles	castled	k#sPz	k#sPd
shows	showed	S5z	S5d
trot	trotted	trQt	trQtId
stresses	stressed	strEsIz	strEst
disengages	disengaged	"dIsIng1_Iz	"dIsIng1_d
topples	toppled	tQpPz	tQpPd
japans	japanned	_@p{nz	_@p{nd
pirates	pirated	p2@r@ts	p2@r@tId
touches	touched	tVJIz	tVJt
stitch	stitched	stIJ	stIJt
mark	marked	m#k	m#kt
blindfolds	blindfolded	bl2ndf5ldz	bl2ndf5ldId
reach	reached	riJ	riJt
crash-land	crash-landed	kr{Sl{nd	kr{Sl{ndId
suits	suited	suts	sutId
trumpet	trumpeted	trVmpIt	trVmpItId
rick	ricked	rIk	rIkt
films	filmed	fIlmz	fIlmd
hides	hid	h2dz	hId
dictate	dictated	dIkt1t	dIkt1tId
registers	registered	rE_Ist@z	rE_Ist@d
unwind	unwound	"Vnw2nd	"Vnw6nd
punish	punished	pVnIS	pVnISt
incorporates	incorporated	Ink$p@r1ts	Ink$p@r1tId
clarify	clarified	kl{rIf2	kl{rIf2d
crosses	crossed	krQsIz	krQst
tallies	tallied	t{lIz	t{lId
await	awaited	@w1t	@w1tId
signal	signalled	sIgnP	sIgnPd
elopes	eloped	Il5ps	Il5pt
debunk	debunked	"dibVNk	"dibVNkt
stops	stopped	stQps	stQpt
bargains	bargained	b#gInz	b#gInd
begin	began	bIgIn	bIg{n
castle	castled	k#sP	k#sPd
devour	devoured	dIv6@R	dIv6@d
overcapitalizes	overcapitalized	"5v@k{pIt@l2zIz	"5v@k{pIt@l2zd
spites	spited	sp2ts	sp2tId
cops	copped	kQps	kQpt
deliberate	deliberated	dIlIb@r1t	dIlIb@r1tId
imagines	imagined	Im{_Inz	Im{_Ind
vivify	vivified	vIvIf2	vIvIf2d
ascertain	ascertained	"{s@t1n	"{s@t1nd
palms	palmed	p#mz	p#md
promote	promoted	pr@m5t	pr@m5tId
dig	dug	dIg	dVg
lob	lobbed	lQb	lQbd
adjudicate	adjudicated	@_udIk1t	@_udIk1tId
pave	paved	p1v	p1vd
specifies	specified	spEsIf2z	spEsIf2d
attends	attended	@tEndz	@tEndId
entreat	entreated	Intrit	IntritId
fractures	fractured	fr{kJ@z	fr{kJ@d
demolishes	demolished	dImQlISIz	dImQlISt
pray	prayed	pr1	pr1d
furls	furled	f3lz	f3ld
entombs	entombed	Intumz	Intumd
override	overrode	"5v@r2d	"5v@r5d
calls	called	k$lz	k$ld
escarp	escarped	Isk#p	Isk#pt
plough	ploughed	pl6	pl6d
foots	footed	fUts	fUtId
varnish	varnished	v#nIS	v#nISt
commences	commenced	k@mEnsIz	k@mEnst
preaches	preached	priJIz	priJt
asterisk	asterisked	{st@rIsk	{st@rIskt
sway	swayed	sw1	sw1d
orphan	orphaned	$fH	$fHd
interlocks	interlocked	"Int@lQks	"Int@lQkt
dandifies	dandified	d{ndIf2z	d{ndIf2d
wangles	wangled	w{NgPz	w{NgPd
electrify	electrified	IlEktrIf2	IlEktrIf2d
bath	bathed	b#T	b1Dd
flings	flung	flINz	flVN
denotes	denoted	dIn5ts	dIn5tId
deposes	deposed	dIp5zIz	dIp5zd
initiate	initiated	InISI1t	InISI1tId
misreads	misread	"mIsridz	"mIsrEd
snow	snowed	sn5	sn5d
ruck	rucked	rVk	rVkt
stumble	stumbled	stVmbP	stVmbPd
vault	vaulted	v$lt	v$ltId
paddles	paddled	p{dPz	p{dPd
fold	folded	f5ld	f5ldId
widen	widened	w2dH	w2dHd
troubles	troubled	trVbPz	trVbPd
tweak	tweaked	twik	twikt
scribble	scribbled	skrIbP	skrIbPd
unbalances	unbalanced	"Vnb{l@nsIz	"Vnb{l@nst
diffracts	diffracted	dIfr{kts	dIfr{ktId
weights	weighted	w1ts	w1tId
apportion	apportioned	@p$SH	@p$SHd
bashes	bashed	b{SIz	b{St
japan	japanned	_@p{n	_@p{nd
plonk	plonked	plQNk	plQNkt
tackles	tackled	t{kPz	t{kPd
chats	chatted	J{ts	J{tId
desegregate	desegregated	"disEgrIg1t	"disEgrIg1tId
tends	tended	tEndz	tEndId
cherish	cherished	JErIS	JErISt
acidifies	acidified	@sIdIf2z	@sIdIf2d
damn	damned	d{m	d{md
settle	settled	sEtP	sEtPd
tile	tiled	t2l	t2ld
betray	betrayed	bItr1	bItr1d
floods	flooded	flVdz	flVdId
photosensitizes	photosensitized	"f5t5sEnsIt2zIz	"f5t5sEnsIt2zd
reply	replied	rIpl2	rIpl2d
seal	sealed	sil	sild
copy	copied	kQpI	kQpId
belch	belched	bElJ	bElJt
misstate	misstated	"mIsst1t	"mIsst1tId
drip	dripped	drIp	drIpt
fake	faked	f1k	f1kt
spay	spayed	sp1	sp1d
imparts	imparted	Imp#ts	Imp#tId
alarms	alarmed	@l#mz	@l#md
pots	potted	pQts	pQtId
congests	congested	k@n_Ests	k@n_EstId
multiply	multiplied	mVltIpl2	mVltIpl2d
malign	maligned	m@l2n	m@l2nd
discountenance	discountenanced	dIsk6ntIn@ns	dIsk6ntIn@nst
get	got	gEt	gQt
objurgates	objurgated	Qb_@g1ts	Qb_@g1tId
whacks	whacked	w{ks	w{kt
beeswaxes	beeswaxed	bizw{ksIz	bizw{kst
parachutes	parachuted	p{r@Suts	p{r@SutId
telescopes	telescoped	tElIsk5ps	tElIsk5pt
locates	located	l5k1ts	l5k1tId
accentuates	accentuated	{ksEntjU1ts	{ksEntjU1tId
mounts	mounted	m6nts	m6ntId
accompanies	accompanied	@kVmp@nIz	@kVmp@nId
revolve	revolved	rIvQlv	rIvQlvd
invest	invested	InvEst	InvEstId
soaks	soaked	s5ks	s5kt
funds	funded	fVndz	fVndId
unwinds	unwound	"Vnw2ndz	"Vnw6nd
ramble	rambled	r{mbP	r{mbPd
graze	grazed	gr1z	gr1zd
foul	fouled	f6l	f6ld
flurries	flurried	flVrIz	flVrId
launders	laundered	l$nd@z	l$nd@d
intrigues	intrigued	Intrigz	Intrigd
appoints	appointed	@p4nts	@p4ntId
nails	nailed	n1lz	n1ld
matches	matched	m{JIz	m{Jt
sop	sopped	sQp	sQpt
stales	staled	st1lz	st1ld
sign	signed	s2n	s2nd
rehear	reheard	"rih7R	"rih3d
spill	spilt	spIl	spIlt
despises	despised	dIsp2zIz	dIsp2zd
structure	structured	strVkJ@R	strVkJ@d
avails	availed	@v1lz	@v1ld
buries	buried	bErIz	bErId
reports	reported	rIp$ts	rIp$tId
contains	contained	k@nt1nz	k@nt1nd
force	forced	f$s	f$st
guzzles	guzzled	gVzPz	gVzPd
treasures	treasured	trEZ@z	trEZ@d
savages	savaged	s{vI_Iz	s{vI_d
entitles	entitled	Int2tPz	Int2tPd
question	questioned	kwEsJ@n	kwEsJ@nd
chants	chanted	J#nts	J#ntId
circumnavigates	circumnavigated	"s3k@mn{vIg1ts	"s3k@mn{vIg1tId
extinguishes	extinguished	IkstINgwISIz	IkstINgwISt
transforms	transformed	tr{nsf$mz	tr{nsf$md
rejoice	rejoiced	rI_4s	rI_4st
stutter	stuttered	stVt@R	stVt@d
poses	posed	p5zIz	p5zd
strangle	strangled	str{NgP	str{NgPd
pillows	pillowed	pIl5z	pIl5d
rips	ripped	rIps	rIpt
distances	distanced	dIst@nsIz	dIst@nst
begs	begged	bEgz	bEgd
supplement	supplemented	sVplImEnt	sVplImEntId
dates	dated	d1ts	d1tId
pour	poured	p$R	p$d
sprout	sprouted	spr6t	spr6tId
skate	skated	sk1t	sk1tId
freewheels	freewheeled	"friwilz	"friwild
betakes	betook	bIt1ks	bItUk
extol	extolled	Ikst5l	Ikst5ld
screw	screwed	skru	skrud
indulge	indulged	IndVl_	IndVl_d
lifts	lifted	lIfts	lIftId
respond	responded	rIspQnd	rIspQndId
booms	boomed	bumz	bumd
fasten	fastened	f#sH	f#sHd
counts	counted	k6nts	k6ntId
lunches	lunched	lVnJIz	lVnJt
fetches	fetched	fEJIz	fEJt
resists	resisted	rIzIsts	rIzIstId
underbids	underbid	"Vnd@bIdz	"Vnd@bId
burlesque	burlesqued	b3lEsk	b3lEskt
booby-traps	booby-trapped	bubItr{ps	bubItr{pt
blues	blued	bluz	blud
glimmers	glimmered	glIm@z	glIm@d
shudder	shuddered	SVd@R	SVd@d
furl	furled	f3l	f3ld
slates	slated	sl1ts	sl1tId
increase	increased	Inkris	Inkrist
experiment	experimented	IkspErIm@nt	IkspErIm@ntId
illuminate	illuminated	IlumIn1t	IlumIn1tId
exhort	exhorted	Igz$t	Igz$tId
prizes	prized	pr2zIz	pr2zd
deploys	deployed	dIpl4z	dIpl4d
trim	trimmed	trIm	trImd
breakfast	breakfasted	brEkf@st	brEkf@stId
repoints	repointed	"rip4nts	"rip4ntId
inaugurates	inaugurated	In$gjUr1ts	In$gjUr1tId
rise	rose	r2z	r5z
vocalize	vocalized	v5k@l2z	v5k@l2zd
shift	shifted	SIft	SIftId
smelt	smelted	smElt	smEltId
exterminates	exterminated	Ikst3mIn1ts	Ikst3mIn1tId
pushes	pushed	pUSIz	pUSt
gates	gated	g1ts	g1tId
educe	educed	idjus	idjust
represses	repressed	rIprEsIz	rIprEst
pools	pooled	pulz	puld
balloons	ballooned	b@lunz	b@lund
counterfeit	counterfeited	k6nt@fIt	k6nt@fItId
designates	designated	dEzIgn1ts	dEzIgn1tId
dilutes	diluted	d2ljuts	d2ljutId
reside	resided	rIz2d	rIz2dId
derail	derailed	dIr1l	dIr1ld
occupies	occupied	QkjUp2z	QkjUp2d
protest	protested	pr@tEst	pr@tEstId
assert	asserted	@s3t	@s3tId
eliminates	eliminated	IlImIn1ts	IlImIn1tId
judge	judged	_V_	_V_d
manipulates	manipulated	m@nIpjUl1ts	m@nIpjUl1tId
flounce	flounced	fl6ns	fl6nst
ridicules	ridiculed	rIdIkjulz	rIdIkjuld
transcend	transcended	tr{nsEnd	tr{nsEndId
repudiates	repudiated	rIpjudI1ts	rIpjudI1tId
lowers	lowered	l5@z	l5@d
enraptures	enraptured	Inr{pJ@z	Inr{pJ@d
coin	coined	k4n	k4nd
savages	savaged	s{vI_Iz	s{vI_d
forms	formed	f$mz	f$md
strives	strove	str2vz	str5v
whack	whacked	w{k	w{kt
redeploy	redeployed	"ridIpl4	"ridIpl4d
bikes	biked	b2ks	b2kt
percolates	percolated	p3k@l1ts	p3k@l1tId
flit	flitted	flIt	flItId
rotates	rotated	r5t1ts	r5t1tId
layers	layered	l1@z	l1@d
cartwheels	cartwheeled	k#twilz	k#twild
swing	swung	swIN	swVN
joins	joined	_4nz	_4nd
glosses	glossed	glQsIz	glQst
illuminates	illuminated	IlumIn1ts	IlumIn1tId
skim	skimmed	skIm	skImd
shoot	shot	Sut	SQt
pickles	pickled	pIkPz	pIkPd
telegraphs	telegraphed	tElIgr#fs	tElIgr#ft
rises	rose	r2zIz	r5z
extend	extended	IkstEnd	IkstEndId
slips	slipped	slIps	slIpt
rebels	rebelled	rIbElz	rIbEld
flunk	flunked	flVNk	flVNkt
womanizes	womanized	wUm@n2zIz	wUm@n2zd
brace	braced	br1s	br1st
alters	altered	$lt@z	$lt@d
number	numbered	nVmb@R	nVmb@d
attains	attained	@t1nz	@t1nd
converts	converted	k@nv3ts	k@nv3tId
vend	vended	vEnd	vEndId
desist	desisted	dIzIst	dIzIstId
reigns	reigned	r1nz	r1nd
paces	paced	p1sIz	p1st
tightens	tightened	t2tHz	t2tHd
factor	factored	f{kt@R	f{kt@d
prospers	prospered	prQsp@z	prQsp@d
film	filmed	fIlm	fIlmd
reconstruct	reconstructed	"rik@nstrVkt	"rik@nstrVktId
vibrates	vibrated	v2br1ts	v2br1tId
core	cored	k$R	k$d
shams	shammed	S{mz	S{md
stays	stayed	st1z	st1d
shakes	shook	S1ks	SUk
jag	jagged	_{g	_{gd
gerrymander	gerrymandered	_ErIm{nd@R	_ErIm{nd@d
relax	relaxed	rIl{ks	rIl{kst
sellotapes	sellotaped	sEl5t1ps	sEl5t1pt
caters	catered	k1t@z	k1t@d
broadens	broadened	br$dHz	br$dHd
infer	inferred	Inf3R	Inf3d
stroll	strolled	str5l	str5ld
beseems	beseemed	bIsimz	bIsimd
disables	disabled	dIs1bPz	dIs1bPd
equalizes	equalized	ikw@l2zIz	ikw@l2zd
restate	restated	"rist1t	"rist1tId
rotate	rotated	r5t1t	r5t1tId
amuse	amused	@mjuz	@mjuzd
right	righted	r2t	r2tId
stem	stemmed	stEm	stEmd
lilt	lilted	lIlt	lIltId
announce	announced	@n6ns	@n6nst
obtains	obtained	@bt1nz	@bt1nd
tile	tiled	t2l	t2ld
bootleg	bootlegged	but"lEg	but"lEgd
magnify	magnified	m{gnIf2	m{gnIf2d
postdates	postdated	"p5std1ts	"p5std1tId
fray	frayed	fr1	fr1d
frowsts	frowsted	fr6sts	fr6stId
cross-refers	cross-referred	"krQsrIf3z	"krQsrIf3d
moulds	moulded	m5ldz	m5ldId
retches	retched	rEJIz	rEJt
overshadow	overshadowed	"5v@S{d5	"5v@S{d5d
contradicts	contradicted	"kQntr@dIkts	"kQntr@dIktId
linger	lingered	lINg@R	lINg@d
freewheel	freewheeled	"friwil	"friwild
transform	transformed	tr{nsf$m	tr{nsf$md
prize	prized	pr2z	pr2zd
retrieves	retrieved	rItrivz	rItrivd
denudes	denuded	dInjudz	dInjudId
abolish	abolished	@bQlIS	@bQlISt
dilly-dally	dilly-dallied	dIlI"d{lI	dIlI"d{lId
hull	hulled	hVl	hVld
disengage	disengaged	"dIsIng1_	"dIsIng1_d
publishes	published	pVblISIz	pVblISt
bombs	bombed	bQmz	bQmd
saves	saved	s1vz	s1vd
swallows	swallowed	swQl5z	swQl5d
hammer	hammered	h{m@R	h{m@d
drain	drained	dr1n	dr1nd
quote	quoted	kw5t	kw5tId
incapacitates	incapacitated	"Ink@p{sIt1ts	"Ink@p{sIt1tId
accept	accepted	@ksEpt	@ksEptId
demolish	demolished	dImQlIS	dImQlISt
discern	discerned	dIs3n	dIs3nd
preheats	preheated	"prihits	"prihitId
reanimate	reanimated	ri{nIm1t	ri{nIm1tId
freeze	froze	friz	fr5z
vomit	vomited	vQmIt	vQmItId
squares	squared	skw8z	skw8d
loosens	loosened	lusHz	lusHd
echo	echoed	Ek5	Ek5d
enter	entered	Ent@R	Ent@d
plumps	plumped	plVmps	plVmpt
cultivates	cultivated	kVltIv1ts	kVltIv1tId
promotes	promoted	pr@m5ts	pr@m5tId
connotes	connoted	k@n5ts	k@n5tId
sail	sailed	s1l	s1ld
predigest	predigested	"prid2_Est	"prid2_EstId
saturate	saturated	s{J@r1t	s{J@r1tId
allow	allowed	@l6	@l6d
butt	butted	bVt	bVtId
pucker	puckered	pVk@R	pVk@d
accuses	accused	@kjuzIz	@kjuzd
cheapen	cheapened	Jip@n	Jip@nd
defeat	defeated	dIfit	dIfitId
prize	prized	pr2z	pr2zd
vitrify	vitrified	vItrIf2	vItrIf2d
quits	quit	kwIts	kwIt
broadcast	broadcast	br$dk#st	br$dk#st
paddle	paddled	p{dP	p{dPd
plunge	plunged	plVn_	plVn_d
mourns	mourned	m$nz	m$nd
migrates	migrated	m2gr1ts	m2gr1tId
block	blocked	blQk	blQkt
conjugate	conjugated	kQn_Ug1t	kQn_Ug1tId
frowst	frowsted	fr6st	fr6stId
races	raced	r1sIz	r1st
shams	shammed	S{mz	S{md
tack	tacked	t{k	t{kt
dwell	dwelt	dwEl	dwElt
persecutes	persecuted	p3sIkjuts	p3sIkjutId
petitions	petitioned	p@tISHz	p@tISHd
undeceive	undeceived	"VndIsiv	"VndIsivd
construct	constructed	k@nstrVkt	k@nstrVktId
drains	drained	dr1nz	dr1nd
tie	tied	t2	t2d
ripen	ripened	r2p@n	r2p@nd
percolates	percolated	p3k@l1ts	p3k@l1tId
wade	waded	w1d	w1dId
waste	wasted	w1st	w1stId
explode	exploded	Ikspl5d	Ikspl5dId
perforate	perforated	p3f@r1t	p3f@r1tId
swoop	swooped	swup	swupt
afford	afforded	@f$d	@f$dId
arraign	arraigned	@r1n	@r1nd
spot	spotted	spQt	spQtId
describes	described	dIskr2bz	dIskr2bd
wrings	wrung	rINz	rVN
talk	talked	t$k	t$kt
test-drive	test-drove	tEstdr2v	tEstdr5v
misspell	misspelt	"mIsspEl	"mIsspElt
learns	learnt	l3nz	l3nt
chirp	chirped	J3p	J3pt
obtrude	obtruded	@btrud	@btrudId
equal	equalled	ikw@l	ikw@ld
detects	detected	dItEkts	dItEktId
streaks	streaked	striks	strikt
fills	filled	fIlz	fIld
cores	cored	k$z	k$d
prevaricates	prevaricated	prIv{rIk1ts	prIv{rIk1tId
worship	worshipped	w3SIp	w3SIpt
mulches	mulched	mVlJIz	mVlJt
conclude	concluded	k@nklud	k@nkludId
equip	equipped	IkwIp	IkwIpt
predominates	predominated	prIdQmIn1ts	prIdQmIn1tId
furs	furred	f3z	f3d
capture	captured	k{pJ@R	k{pJ@d
confuse	confused	k@nfjuz	k@nfjuzd
kill	killed	kIl	kIld
determines	determined	dIt3mInz	dIt3mInd
castrate	castrated	k{str1t	k{str1tId
collapses	collapsed	k@l{psIz	k@l{pst
indentures	indentured	IndEnJ@z	IndEnJ@d
tempt	tempted	tEmpt	tEmptId
separate	separated	sEp@r1t	sEp@r1tId
harms	harmed	h#mz	h#md
off-loads	off-loaded	"Qfl5dz	"Qfl5dId
shifts	shifted	SIfts	SIftId
wanks	wanked	w{Nks	w{Nkt
agrees	agreed	@griz	@grid
milks	milked	mIlks	mIlkt
peculates	peculated	pEkjUl1ts	pEkjUl1tId
bethink	bethought	bITINk	bIT$t
straighten	straightened	str1tH	str1tHd
knots	knotted	nQts	nQtId
squeaks	squeaked	skwiks	skwikt
memorialize	memorialized	m@m$r7l2z	m@m$r7l2zd
wed	wed	wEd	wEd
contest	contested	k@ntEst	k@ntEstId
senses	sensed	sEnsIz	sEnst
argue	argued	#gju	#gjud
rook	rooked	rUk	rUkt
progresses	progressed	pr5grEsIz	pr5grEst
count	counted	k6nt	k6ntId
interlock	interlocked	"Int@lQk	"Int@lQkt
replays	replayed	"ripl1z	"ripl1d
hallmark	hallmarked	h$lm#k	h$lm#kt
botanize	botanized	bQt@n2z	bQt@n2zd
depict	depicted	dIpIkt	dIpIktId
beatify	beatified	bi{tIf2	bi{tIf2d
enlists	enlisted	InlIsts	InlIstId
rucks	rucked	rVks	rVkt
exceeds	exceeded	Iksidz	IksidId
retains	retained	rIt1nz	rIt1nd
distorts	distorted	dIst$ts	dIst$tId
wheedle	wheedled	widP	widPd
prohibits	prohibited	pr@hIbIts	pr@hIbItId
trims	trimmed	trImz	trImd
pettifog	pettifogged	pEtIfQg	pEtIfQgd
repeats	repeated	rIpits	rIpitId
fishes	fished	fISIz	fISt
skulk	skulked	skVlk	skVlkt
pinpoint	pinpointed	pInp4nt	pInp4ntId
structures	structured	strVkJ@z	strVkJ@d
pole-vaults	pole-vaulted	p5lv$lts	p5lv$ltId
stock	stocked	stQk	stQkt
palatalizes	palatalized	p{l@t@l2zIz	p{l@t@l2zd
shrink	shrunk	SrINk	SrVNk
impress	impressed	ImprEs	ImprEst
chronicle	chronicled	krQnIkP	krQnIkPd
rooks	rooked	rUks	rUkt
communicate	communicated	k@mjunIk1t	k@mjunIk1tId
osculates	osculated	QskjUl1ts	QskjUl1tId
zone	zoned	z5n	z5nd
look	looked	lUk	lUkt
commissions	commissioned	k@mISHz	k@mISHd
lessen	lessened	lEsH	lEsHd
bets	bet	bEts	bEt
unroll	unrolled	"Vnr5l	"Vnr5ld
prims	primmed	prImz	prImd
deodorizes	deodorized	di5d@r2zIz	di5d@r2zd
couch	couched	k6J	k6Jt
concludes	concluded	k@nkludz	k@nkludId
manipulate	manipulated	m@nIpjUl1t	m@nIpjUl1tId
hire	hired	h2@R	h2@d
expels	expelled	IkspElz	IkspEld
commence	commenced	k@mEns	k@mEnst
jingle	jingled	_INgP	_INgPd
enlarge	enlarged	Inl#_	Inl#_d
noose	noosed	nus	nust
appose	apposed	{p5z	{p5zd
scrutinize	scrutinized	skrutIn2z	skrutIn2zd
grab	grabbed	gr{b	gr{bd
undermine	undermined	"Vnd@m2n	"Vnd@m2nd
affranchise	affranchised	@fr{nJ2z	@fr{nJ2zd
site	sited	s2t	s2tId
wheedles	wheedled	widPz	widPd
outdates	outdated	6td1ts	6td1tId
belittles	belittled	bIlItPz	bIlItPd
assimilates	assimilated	@sImIl1ts	@sImIl1tId
cross-refer	cross-referred	"krQsrIf3R	"krQsrIf3d
undercut	undercut	"Vnd@kVt	"Vnd@kVt
slumps	slumped	slVmps	slVmpt
predestinate	predestinated	"pridEstIn1t	"pridEstIn1tId
leaves	left	livz	lEft
view	viewed	vju	vjud
bawl	bawled	b$l	b$ld
think	thought	TINk	T$t
annoys	annoyed	@n4z	@n4d
own	owned	5n	5nd
defines	defined	dIf2nz	dIf2nd
advance	advanced	@dv#ns	@dv#nst
medicate	medicated	mEdIk1t	mEdIk1tId
titillate	titillated	tItIl1t	tItIl1tId
trumpets	trumpeted	trVmpIts	trVmpItId
bash	bashed	b{S	b{St
twit	twitted	twIt	twItId
embrocates	embrocated	Embr5k1ts	Embr5k1tId
countervails	countervailed	k6nt@v1lz	k6nt@v1ld
hallucinates	hallucinated	h@lusIn1ts	h@lusIn1tId
crouch	crouched	kr6J	kr6Jt
stale	staled	st1l	st1ld
conceive	conceived	k@nsiv	k@nsivd
apposes	apposed	{p5zIz	{p5zd
evict	evicted	IvIkt	IvIktId
jerk	jerked	_3k	_3kt
undernourish	undernourished	"Vnd@nVrIS	"Vnd@nVrISt
empanels	empanelled	Imp{nPz	Imp{nPd
patronizes	patronized	p{tr@n2zIz	p{tr@n2zd
tips	tipped	tIps	tIpt
mar	marred	m#R	m#d
sustain	sustained	s@st1n	s@st1nd
distend	distended	dIstEnd	dIstEndId
poach	poached	p5J	p5Jt
flops	flopped	flQps	flQpt
equips	equipped	IkwIps	IkwIpt
effaces	effaced	If1sIz	If1st
aquaplanes	aquaplaned	{kw@pl1nz	{kw@pl1nd
probates	probated	pr5b1ts	pr5b1tId
countermarch	countermarched	k6nt@m#J	k6nt@m#Jt
profits	profited	prQfIts	prQfItId
perches	perched	p3JIz	p3Jt
inhales	inhaled	Inh1lz	Inh1ld
swear	swore	sw8R	sw$R
interests	interested	Intr@sts	Intr@stId
poaches	poached	p5JIz	p5Jt
rolls	rolled	r5lz	r5ld
balances	balanced	b{l@nsIz	b{l@nst
tables	tabled	t1bPz	t1bPd
lugs	lugged	lVgz	lVgd
detach	detached	dIt{J	dIt{Jt
ushers	ushered	VS@z	VS@d
pestles	pestled	pEsPz	pEsPd
nears	neared	n7z	n7d
figures	figured	fIg@z	fIg@d
locate	located	l5k1t	l5k1tId
caws	cawed	k$z	k$d
bashes	bashed	b{SIz	b{St
afforests	afforested	{fQrIsts	{fQrIstId
proofread	proofread	prufrEd	prufrEd
disintegrate	disintegrated	dIsIntIgr1t	dIsIntIgr1tId
giggles	giggled	gIgPz	gIgPd
accentuates	accentuated	{ksEntjU1ts	{ksEntjU1tId
plans	planned	pl{nz	pl{nd
tidy	tidied	t2dI	t2dId
reconstructs	reconstructed	"rik@nstrVkts	"rik@nstrVktId
illumine	illumined	IlumIn	IlumInd
perch	perched	p3J	p3Jt
resides	resided	rIz2dz	rIz2dId
flush	flushed	flVS	flVSt
calms	calmed	k#mz	k#md
differentiate	differentiated	"dIf@rEnSI1t	"dIf@rEnSI1tId
appoint	appointed	@p4nt	@p4ntId
varies	varied	v8rIz	v8rId
shout	shouted	S6t	S6tId
mortgage	mortgaged	m$gI_	m$gI_d
glorifies	glorified	gl$rIf2z	gl$rIf2d
glorify	glorified	gl$rIf2	gl$rIf2d
explodes	exploded	Ikspl5dz	Ikspl5dId
delight	delighted	dIl2t	dIl2tId
unsettle	unsettled	"VnsEtP	"VnsEtPd
murder	murdered	m3d@R	m3d@d
beg	begged	bEg	bEgd
cause	caused	k$z	k$zd
inters	interred	Int3z	Int3d
maims	maimed	m1mz	m1md
abandons	abandoned	@b{nd@nz	@b{nd@nd
forbears	forbore	f$b8z	f$b$R
discuss	discussed	dIskVs	dIskVst
fathom	fathomed	f{D@m	f{D@md
adorns	adorned	@d$nz	@d$nd
scores	scored	sk$z	sk$d
pall	palled	p$l	p$ld
collar	collared	kQl@R	kQl@d
perform	performed	p@f$m	p@f$md
gull	gulled	gVl	gVld
re-cover	re-covered	"rikVv@R	"rikVv@d
mind	minded	m2nd	m2ndId
ionize	ionized	2@n2z	2@n2zd
samples	sampled	s#mpPz	s#mpPd
heaps	heaped	hips	hipt
hate	hated	h1t	h1tId
sharpen	sharpened	S#p@n	S#p@nd
zoom	zoomed	zum	zumd
lambs	lambed	l{mz	l{md
patronize	patronized	p{tr@n2z	p{tr@n2zd
consents	consented	k@nsEnts	k@nsEntId
grants	granted	gr#nts	gr#ntId
paddles	paddled	p{dPz	p{dPd
deliquesces	deliquesced	"dElIkwEsIz	"dElIkwEst
import	imported	Imp$t	Imp$tId
spays	spayed	sp1z	sp1d
stow	stowed	st5	st5d
discredits	discredited	dIskrEdIts	dIskrEdItId
spade	spaded	sp1d	sp1dId
cheat	cheated	Jit	JitId
wrongs	wronged	rQNz	rQNd
apprise	apprised	@pr2z	@pr2zd
combat	combatted	kQmb{t	kQmb{tId
initial	initialled	InISP	InISPd
wanton	wantoned	wQnt@n	wQnt@nd
deserve	deserved	dIz3v	dIz3vd
inflame	inflamed	Infl1m	Infl1md
sullies	sullied	sVlIz	sVlId
uphold	upheld	Vph5ld	VphEld
perforates	perforated	p3f@r1ts	p3f@r1tId
bate	bated	b1t	b1tId
tickets	ticketed	tIkIts	tIkItId
dissatisfies	dissatisfied	"dIss{tIsf2z	"dIss{tIsf2d
readjusts	readjusted	"ri@_Vsts	"ri@_VstId
caress	caressed	k@rEs	k@rEst
decimate	decimated	dEsIm1t	dEsIm1tId
secures	secured	sIkj9z	sIkj9d
memorizes	memorized	mEm@r2zIz	mEm@r2zd
kotows	kotowed	"k5t6z	"k5t6d
purr	purred	p3R	p3d
stuccos	stuccoed	stVk5z	stVk5d
franks	franked	fr{Nks	fr{Nkt
hazes	hazed	h1zIz	h1zd
criticize	criticized	krItIs2z	krItIs2zd
evolves	evolved	IvQlvz	IvQlvd
lead	led	lid	lEd
arrogate	arrogated	{r5g1t	{r5g1tId
represent	represented	"rEprIzEnt	"rEprIzEntId
sentence	sentenced	sEnt@ns	sEnt@nst
vaults	vaulted	v$lts	v$ltId
convey	conveyed	k@nv1	k@nv1d
blame	blamed	bl1m	bl1md
tarmacs	tarmacked	t#m{ks	t#m{kt
digs	dug	dIgz	dVg
remove	removed	rImuv	rImuvd
stimulate	stimulated	stImjUl1t	stImjUl1tId
thrills	thrilled	TrIlz	TrIld
chop	chopped	JQp	JQpt
dispenses	dispensed	dIspEnsIz	dIspEnst
sink	sank	sINk	s{Nk
reproduce	reproduced	"ripr@djus	"ripr@djust
sorts	sorted	s$ts	s$tId
messes	messed	mEsIz	mEst
ensconces	ensconced	InskQnsIz	InskQnst
distinguish	distinguished	dIstINgwIS	dIstINgwISt
secularizes	secularized	sEkjUl@r2zIz	sEkjUl@r2zd
costs	cost	kQsts	kQst
arouses	aroused	@r6zIz	@r6zd
prizes	prized	pr2zIz	pr2zd
safeguard	safeguarded	s1fg#d	s1fg#dId
gawp	gawped	g$p	g$pt
overhauls	overhauled	"5v@h$lz	"5v@h$ld
digress	digressed	d2grEs	d2grEst
adapts	adapted	@d{pts	@d{ptId
stir	stirred	st3R	st3d
solaces	solaced	sQl@sIz	sQl@st
publish	published	pVblIS	pVblISt
trumpet	trumpeted	trVmpIt	trVmpItId
spay	spayed	sp1	sp1d
twit	twitted	twIt	twItId
orders	ordered	$d@z	$d@d
soothe	soothed	suD	suDd
remain	remained	rIm1n	rIm1nd
bends	bent	bEndz	bEnt
roll	rolled	r5l	r5ld
flinch	flinched	flInJ	flInJt
mutilates	mutilated	mjutIl1ts	mjutIl1tId
code	coded	k5d	k5dId
prefix	prefixed	"prifIks	"prifIkst
subscribes	subscribed	s@bskr2bz	s@bskr2bd
live	lived	lIv	lIvd
surmises	surmised	s3m2zIz	s3m2zd
tittle-tattle	tittle-tattled	tItP"t{tP	tItP"t{tPd
embrace	embraced	Imbr1s	Imbr1st
anoints	anointed	@n4nts	@n4ntId
pries	pried	pr2z	pr2d
prefaces	prefaced	prEfIsIz	prEfIst
dropkicks	dropkicked	drQp"kIks	drQp"kIkt
blitzes	blitzed	blItsIz	blItst
adjourns	adjourned	@_3nz	@_3nd
dismiss	dismissed	dIsmIs	dIsmIst
distrust	distrusted	dIstrVst	dIstrVstId
derail	derailed	dIr1l	dIr1ld
saunter	sauntered	s$nt@R	s$nt@d
garden	gardened	g#dH	g#dHd
withdraw	withdrew	wIDdr$	wIDdru
enfranchises	enfranchised	Infr{nJ2zIz	Infr{nJ2zd
quibbles	quibbled	kwIbPz	kwIbPd
lather	lathered	l#D@R	l#D@d
peers	peered	p7z	p7d
accepts	accepted	@ksEpts	@ksEptId
discountenances	discountenanced	dIsk6ntIn@nsIz	dIsk6ntIn@nst
foresees	foresaw	f$siz	f$s$
cocoons	cocooned	k@kunz	k@kund
barge	barged	b#_	b#_d
deflate	deflated	dIfl1t	dIfl1tId
jettison	jettisoned	_EtIsH	_EtIsHd
answers	answered	#ns@z	#ns@d
replay	replayed	"ripl1	"ripl1d
taxes	taxed	t{ksIz	t{kst
digresses	digressed	d2grEsIz	d2grEst
perches	perched	p3JIz	p3Jt
nods	nodded	nQdz	nQdId
aligns	aligned	@l2nz	@l2nd
subscribe	subscribed	s@bskr2b	s@bskr2bd
decline	declined	dIkl2n	dIkl2nd
displeases	displeased	dIsplizIz	dIsplizd
proclaims	proclaimed	pr@kl1mz	pr@kl1md
mobilize	mobilized	m5bIl2z	m5bIl2zd
blackguard	blackguarded	bl{g#d	bl{g#dId
maul	mauled	m$l	m$ld
diagnose	diagnosed	d2@gn5z	d2@gn5zd
immure	immured	Imj9R	Imj9d
premiere	premiered	prEmI8R	prEmI8d
realizes	realized	r7l2zIz	r7l2zd
cobble	cobbled	kQbP	kQbPd
osculate	osculated	QskjUl1t	QskjUl1tId
lambaste	lambasted	l{mb1st	l{mb1stId
predominates	predominated	prIdQmIn1ts	prIdQmIn1tId
thank	thanked	T{Nk	T{Nkt
devils	devilled	dEvPz	dEvPd
outrival	outrivalled	"6tr2vP	"6tr2vPd
recurs	recurred	rIk3z	rIk3d
undergo	underwent	"Vnd@g5	"Vnd@wEnt
microfilms	microfilmed	m2kr5fIlmz	m2kr5fIlmd
reduce	reduced	rIdjus	rIdjust
clam	clammed	kl{m	kl{md
dyes	dyed	d2z	d2d
apportions	apportioned	@p$SHz	@p$SHd
interferes	interfered	"Int@f7z	"Int@f7d
ties	tied	t2z	t2d
magnifies	magnified	m{gnIf2z	m{gnIf2d
tiles	tiled	t2lz	t2ld
ham	hammed	h{m	h{md
tire	tired	t2@R	t2@d
acclaims	acclaimed	@kl1mz	@kl1md
macerates	macerated	m{s@r1ts	m{s@r1tId
absolve	absolved	@bzQlv	@bzQlvd
honks	honked	hQNks	hQNkt
expunge	expunged	IkspVn_	IkspVn_d
gorge	gorged	g$_	g$_d
interchange	interchanged	"Int@J1n_	"Int@J1n_d
short-changes	short-changed	"S$tJ1n_Iz	"S$tJ1n_d
lie	lied	l2	l2d
telephones	telephoned	tElIf5nz	tElIf5nd
continues	continued	k@ntInjuz	k@ntInjud
bike	biked	b2k	b2kt
slug	slugged	slVg	slVgd
avail	availed	@v1l	@v1ld
detonate	detonated	dEt@n1t	dEt@n1tId
arms	armed	#mz	#md
unscrew	unscrewed	"Vnskru	"Vnskrud
enjoins	enjoined	In_4nz	In_4nd
portray	portrayed	p$tr1	p$tr1d
define	defined	dIf2n	dIf2nd
enamels	enamelled	In{mPz	In{mPd
rope	roped	r5p	r5pt
perfects	perfected	p@fEkts	p@fEktId
bobsleighs	bobsleighed	bQbsl1z	bQbsl1d
chlorinate	chlorinated	kl$rIn1t	kl$rIn1tId
pines	pined	p2nz	p2nd
glances	glanced	gl#nsIz	gl#nst
trammel	trammelled	tr{mP	tr{mPd
tabulate	tabulated	t{bjUl1t	t{bjUl1tId
authorizes	authorized	$T@r2zIz	$T@r2zd
romanticize	romanticized	r5m{ntIs2z	r5m{ntIs2zd
belie	belied	bIl2	bIl2d
cloud	clouded	kl6d	kl6dId
disjoints	disjointed	dIs_4nts	dIs_4ntId
near	neared	n7R	n7d
communicates	communicated	k@mjunIk1ts	k@mjunIk1tId
unscrew	unscrewed	"Vnskru	"Vnskrud
bites	bit	b2ts	bIt
salvage	salvaged	s{lvI_	s{lvI_d
smiles	smiled	sm2lz	sm2ld
emerges	emerged	Im3_Iz	Im3_d
hug	hugged	hVg	hVgd
cop	copped	kQp	kQpt
warms	warmed	w$mz	w$md
twigs	twigged	twIgz	twIgd
conjoin	conjoined	k@n_4n	k@n_4nd
iodize	iodized	25d2z	25d2zd
conciliates	conciliated	k@nsIlI1ts	k@nsIlI1tId
wail	wailed	w1l	w1ld
queue	queued	kju	kjud
preconceives	preconceived	"prik@nsivz	"prik@nsivd
enraptures	enraptured	Inr{pJ@z	Inr{pJ@d
leaches	leached	liJIz	liJt
undernourishes	undernourished	"Vnd@nVrISIz	"Vnd@nVrISt
achieves	achieved	@Jivz	@Jivd
hounds	hounded	h6ndz	h6ndId
frolics	frolicked	frQlIks	frQlIkt
lump	lumped	lVmp	lVmpt
pipe	piped	p2p	p2pt
inspects	inspected	InspEkts	InspEktId
misread	misread	"mIsrEd	"mIsrEd
tolls	tolled	t5lz	t5ld
disafforests	disafforested	"dIs@fQrIsts	"dIs@fQrIstId
end	ended	End	EndId
centres	centred	sEnt@z	sEnt@d
stutters	stuttered	stVt@z	stVt@d
surmise	surmised	s3m2z	s3m2zd
sully	sullied	sVlI	sVlId
adjudicates	adjudicated	@_udIk1ts	@_udIk1tId
muffs	muffed	mVfs	mVft
bung	bunged	bVN	bVNd
harden	hardened	h#dH	h#dHd
assault	assaulted	@s$lt	@s$ltId
assure	assured	@S$R	@S$d
symbolizes	symbolized	sImb@l2zIz	sImb@l2zd
moralize	moralized	mQr@l2z	mQr@l2zd
maintain	maintained	m1nt1n	m1nt1nd
afforest	afforested	{fQrIst	{fQrIstId
doctors	doctored	dQkt@z	dQkt@d
sparkle	sparkled	sp#kP	sp#kPd
lumps	lumped	lVmps	lVmpt
chirps	chirped	J3ps	J3pt
disconnects	disconnected	"dIsk@nEkts	"dIsk@nEktId
circumvent	circumvented	"s3k@mvEnt	"s3k@mvEntId
characterize	characterized	k{r@kt@r2z	k{r@kt@r2zd
sprouts	sprouted	spr6ts	spr6tId
surmounts	surmounted	s3m6nts	s3m6ntId
distance	distanced	dIst@ns	dIst@nst
assist	assisted	@sIst	@sIstId
accelerates	accelerated	@ksEl@r1ts	@ksEl@r1tId
beat	beat	bit	bit
stores	stored	st$z	st$d
bleed	bled	blid	blEd
expunges	expunged	IkspVn_Iz	IkspVn_d
worships	worshipped	w3SIps	w3SIpt
misunderstands	misunderstood	"mIsVnd@st{ndz	"mIsVnd@stUd
organize	organized	$g@n2z	$g@n2zd
manicure	manicured	m{nI"kj9R	m{nI"kj9d
assume	assumed	@sjum	@sjumd
overrides	overrode	"5v@r2dz	"5v@r5d
displeases	displeased	dIsplizIz	dIsplizd
pecks	pecked	pEks	pEkt
castles	castled	k#sPz	k#sPd
rakes	raked	r1ks	r1kt
arise	arose	@r2z	@r5z
procreates	procreated	pr5krI1ts	pr5krI1tId
staffs	staffed	st#fs	st#ft
inherit	inherited	InhErIt	InhErItId
circumvents	circumvented	"s3k@mvEnts	"s3k@mvEntId
dabbles	dabbled	d{bPz	d{bPd
break	broke	br1k	br5k
proceeds	proceeded	pr@sidz	pr@sidId
dropkick	dropkicked	drQp"kIk	drQp"kIkt
intermits	intermitted	"Int@mIts	"Int@mItId
overbalance	overbalanced	"5v@b{l@ns	"5v@b{l@nst
seesaw	seesawed	sis$	sis$d
ram	rammed	r{m	r{md
ally	allied	@l2	@l2d
sleeks	sleeked	sliks	slikt
adapt	adapted	@d{pt	@d{ptId
weighs	weighed	w1z	w1d
encamp	encamped	Ink{mp	Ink{mpt
ricochet	ricochetted	rIk@S1	rIk@S1d
palatalizes	palatalized	p{l@t@l2zIz	p{l@t@l2zd
airlift	airlifted	8lIft	8lIftId
wish	wished	wIS	wISt
macadamizes	macadamized	m@k{d@m2zIz	m@k{d@m2zd
pleases	pleased	plizIz	plizd
warm	warmed	w$m	w$md
drag	drug	dr{g	drVg
forestalls	forestalled	f$st$lz	f$st$ld
pauses	paused	p$zIz	p$zd
suffer	suffered	sVf@R	sVf@d
subpoena	subpoenaed	s@bpin@	s@bpin@d
counterfeits	counterfeited	k6nt@fIts	k6nt@fItId
gutters	guttered	gVt@z	gVt@d
clean	cleaned	klin	klind
reconsiders	reconsidered	"rik@nsId@z	"rik@nsId@d
straiten	straitened	str1tH	str1tHd
libel	libelled	l2bP	l2bPd
straightens	straightened	str1tHz	str1tHd
staff	staffed	st#f	st#ft
interest	interested	Intr@st	Intr@stId
orphans	orphaned	$fHz	$fHd
applaud	applauded	@pl$d	@pl$dId
nurse	nursed	n3s	n3st
parley	parleyed	p#lI	p#lId
justify	justified	_VstIf2	_VstIf2d
deteriorates	deteriorated	dIt7r7r1ts	dIt7r7r1tId
record	recorded	rIk$d	rIk$dId
intrigue	intrigued	Intrig	Intrigd
queues	queued	kjuz	kjud
widens	widened	w2dHz	w2dHd
slip	slipped	slIp	slIpt
medicates	medicated	mEdIk1ts	mEdIk1tId
piles	piled	p2lz	p2ld
traps	trapped	tr{ps	tr{pt
commission	commissioned	k@mISH	k@mISHd
polices	policed	p@lisIz	p@list
whisk	whisked	wIsk	wIskt
placards	placarded	pl{k#dz	pl{k#dId
attracts	attracted	@tr{kts	@tr{ktId
rehash	rehashed	"rih{S	"rih{St
disrupts	disrupted	dIsrVpts	dIsrVptId
disarm	disarmed	dIs#m	dIs#md
compose	composed	k@mp5z	k@mp5zd
hurdles	hurdled	h3dPz	h3dPd
manages	managed	m{nI_Iz	m{nI_d
forecast	forecast	f$k#st	f$k#st
replicate	replicated	rEplIk1t	rEplIk1tId
airlifts	airlifted	8lIfts	8lIftId
copulates	copulated	kQpjUl1ts	kQpjUl1tId
exults	exulted	IgzVlts	IgzVltId
dazzles	dazzled	d{zPz	d{zPd
sandblasts	sandblasted	s{ndbl#sts	s{ndbl#stId
swells	swelled	swElz	swEld
billow	billowed	bIl5	bIl5d
neglects	neglected	nIglEkts	nIglEktId
pings	pinged	pINz	pINd
rives	rove	r2vz	r5v
infects	infected	InfEkts	InfEktId
combine	combined	k@mb2n	k@mb2nd
intercalates	intercalated	Int3k@l1ts	Int3k@l1tId
unveils	unveiled	"Vnv1lz	"Vnv1ld
reminisce	reminisced	"rEmInIs	"rEmInIst
forswear	forswore	f$sw8R	f$sw$R
docks	docked	dQks	dQkt
concedes	conceded	k@nsidz	k@nsidId
lack	lacked	l{k	l{kt
slate	slated	sl1t	sl1tId
debit	debited	dEbIt	dEbItId
disendows	disendowed	"dIsInd6z	"dIsInd6d
affranchises	affranchised	@fr{nJ2zIz	@fr{nJ2zd
spray	sprayed	spr1	spr1d
discipline	disciplined	dIsIplIn	dIsIplInd
preachifies	preachified	priJIf2z	priJIf2d
enrapture	enraptured	Inr{pJ@R	Inr{pJ@d
breathe	breathed	briD	briDd
endorse	endorsed	Ind$s	Ind$st
admit	admitted	@dmIt	@dmItId
renews	renewed	rInjuz	rInjud
autograph	autographed	$t@gr#f	$t@gr#ft
tamps	tamped	t{mps	t{mpt
inoculates	inoculated	InQkjUl1ts	InQkjUl1tId
game	gamed	g1m	g1md
retires	retired	rIt2@z	rIt2@d
surround	surrounded	s@r6nd	s@r6ndId
stets	stetted	stEts	stEtId
shinnies	shinnied	SInIz	SInId
proliferate	proliferated	pr5lIf@r1t	pr5lIf@r1tId
shackle	shackled	S{kP	S{kPd
contend	contended	k@ntEnd	k@ntEndId
disregard	disregarded	"dIsrIg#d	"dIsrIg#dId
balance	balanced	b{l@ns	b{l@nst
machine	machined	m@Sin	m@Sind
measure	measured	mEZ@R	mEZ@d
bind	bound	b2nd	b6nd
cobbles	cobbled	kQbPz	kQbPd
beseem	beseemed	bIsim	bIsimd
strokes	stroked	str5ks	str5kt
styles	styled	st2lz	st2ld
snuff	snuffed	snVf	snVft
oppugn	oppugned	@pjun	@pjund
meets	met	mits	mEt
consoles	consoled	k@ns5lz	k@ns5ld
crown	crowned	kr6n	kr6nd
maturates	maturated	m{tjUr1ts	m{tjUr1tId
ferries	ferried	fErIz	fErId
scythe	scythed	s2D	s2Dd
theorize	theorized	T7r2z	T7r2zd
reinforce	reinforced	"riInf$s	"riInf$st
nerve	nerved	n3v	n3vd
bypass	bypassed	b2p#s	b2p#st
bloom	bloomed	blum	blumd
run	ran	rVn	r{n
murmurs	murmured	m3m@z	m3m@d
fuck	fucked	fVk	fVkt
prevaricate	prevaricated	prIv{rIk1t	prIv{rIk1tId
instructs	instructed	InstrVkts	InstrVktId
purvey	purveyed	p@v1	p@v1d
trusts	trusted	trVsts	trVstId
prove	proved	pruv	pruvd
lynch	lynched	lInJ	lInJt
dread	dreaded	drEd	drEdId
invent	invented	InvEnt	InvEntId
spit	spit	spIt	spIt
whines	whined	w2nz	w2nd
inconvenience	inconvenienced	"Ink@nvinj@ns	"Ink@nvinj@nst
defy	defied	dIf2	dIf2d
ice	iced	2s	2st
photosensitize	photosensitized	"f5t5sEnsIt2z	"f5t5sEnsIt2zd
request	requested	rIkwEst	rIkwEstId
overpowers	overpowered	"5v@p6@z	"5v@p6@d
stereotype	stereotyped	st7r7t2p	st7r7t2pt
pockets	pocketed	pQkIts	pQkItId
spays	spayed	sp1z	sp1d
snigger	sniggered	snIg@R	snIg@d
brightens	brightened	br2tHz	br2tHd
allay	allayed	@l1	@l1d
shoots	shot	Suts	SQt
legitimizes	legitimized	lI_ItIm2zIz	lI_ItIm2zd
scoffs	scoffed	skQfs	skQft
bemoan	bemoaned	bIm5n	bIm5nd
scratches	scratched	skr{JIz	skr{Jt
disentangles	disentangled	"dIsInt{NgPz	"dIsInt{NgPd
unites	united	jun2ts	jun2tId
guide	guided	g2d	g2dId
outbid	outbid	"6tbId	"6tbId
buzz	buzzed	bVz	bVzd
kotow	kotowed	"k5t6	"k5t6d
lets	let	lEts	lEt
overshadows	overshadowed	"5v@S{d5z	"5v@S{d5d
lambasts	lambasted	l{mb1sts	l{mb1stId
wander	wandered	wQnd@R	wQnd@d
matters	mattered	m{t@z	m{t@d
reorganize	reorganized	"ri$g@n2z	"ri$g@n2zd
commemorates	commemorated	k@mEm@r1ts	k@mEm@r1tId
nasalizes	nasalized	n1z@l2zIz	n1z@l2zd
exterminates	exterminated	Ikst3mIn1ts	Ikst3mIn1tId
unlocks	unlocked	"VnlQks	"VnlQkt
print	printed	prInt	prIntId
distrusts	distrusted	dIstrVsts	dIstrVstId
convinces	convinced	k@nvInsIz	k@nvInst
unveil	unveiled	"Vnv1l	"Vnv1ld
recaptures	recaptured	"rik{pJ@z	"rik{pJ@d
vends	vended	vEndz	vEndId
dispels	dispelled	dIspElz	dIspEld
reinforces	reinforced	"riInf$sIz	"riInf$st
invigilate	invigilated	InvI_Il1t	InvI_Il1tId
celebrate	celebrated	sElIbr1t	sElIbr1tId
fool	fooled	ful	fuld
shrimps	shrimped	SrImps	SrImpt
cavort	cavorted	k@v$t	k@v$tId
confides	confided	k@nf2dz	k@nf2dId
thanks	thanked	T{Nks	T{Nkt
bake	baked	b1k	b1kt
decarbonize	decarbonized	"dik#b@n2z	"dik#b@n2zd
map	mapped	m{p	m{pt
personifies	personified	p@sQnIf2z	p@sQnIf2d
tattle	tattled	t{tP	t{tPd
pile	piled	p2l	p2ld
spite	spited	sp2t	sp2tId
enhance	enhanced	Inh#ns	Inh#nst
treasure	treasured	trEZ@R	trEZ@d
stress	stressed	strEs	strEst
procreate	procreated	pr5krI1t	pr5krI1tId
earths	earthed	3Ts	3Tt
strolls	strolled	str5lz	str5ld
taste	tasted	t1st	t1stId
photograph	photographed	f5t@gr#f	f5t@gr#ft
derails	derailed	dIr1lz	dIr1ld
clings	clung	klINz	klVN
gives	gave	gIvz	g1v
factorizes	factorized	f{kt@r2zIz	f{kt@r2zd
guides	guided	g2dz	g2dId
tries	tried	tr2z	tr2d
competes	competed	k@mpits	k@mpitId
pancake	pancaked	p{Nk1k	p{Nk1kt
perseveres	persevered	"p3sIv7z	"p3sIv7d
filters	filtered	fIlt@z	fIlt@d
peep	peeped	pip	pipt
shall	should	S{l	SUd
advertises	advertised	{dv@t2zIz	{dv@t2zd
vitrify	vitrified	vItrIf2	vItrIf2d
wheedle	wheedled	widP	widPd
decants	decanted	dIk{nts	dIk{ntId
revels	revelled	rEvPz	rEvPd
eviscerate	eviscerated	IvIs@r1t	IvIs@r1tId
see	saw	si	s$
entrench	entrenched	IntrEnJ	IntrEnJt
admits	admitted	@dmIts	@dmItId
squeeze	squeezed	skwiz	skwizd
sways	swayed	sw1z	sw1d
utter	uttered	Vt@R	Vt@d
listens	listened	lIsHz	lIsHd
illumine	illumined	IlumIn	IlumInd
head	headed	hEd	hEdId
saunters	sauntered	s$nt@z	s$nt@d
flounders	floundered	fl6nd@z	fl6nd@d
appear	appeared	@p7R	@p7d
tittle-tattles	tittle-tattled	tItP"t{tPz	tItP"t{tPd
motors	motored	m5t@z	m5t@d
testifies	testified	tEstIf2z	tEstIf2d
destroys	destroyed	dIstr4z	dIstr4d
copulate	copulated	kQpjUl1t	kQpjUl1tId
decides	decided	dIs2dz	dIs2dId
reneges	reneged	rInigz	rInigd
headline	headlined	hEdl2n	hEdl2nd
purchase	purchased	p3J@s	p3J@st
refreshes	refreshed	rIfrESIz	rIfrESt
sleets	sleeted	slits	slitId
unhinges	unhinged	"VnhIn_Iz	"VnhIn_d
fakes	faked	f1ks	f1kt
interacts	interacted	"Int@r{kts	"Int@r{ktId
stunts	stunted	stVnts	stVntId
alienate	alienated	1lj@n1t	1lj@n1tId
back	backed	b{k	b{kt
boast	boasted	b5st	b5stId
skewer	skewered	skju@R	skju@d
approximates	approximated	@prQksIm1ts	@prQksIm1tId
forces	forced	f$sIz	f$st
mistimes	mistimed	"mIst2mz	"mIst2md
buckets	bucketed	bVkIts	bVkItId
manicures	manicured	m{nI"kj9z	m{nI"kj9d
headlines	headlined	hEdl2nz	hEdl2nd
bulls	bulled	bUlz	bUld
diet	dieted	d2@t	d2@tId
hedgehops	hedgehopped	hE_hQps	hE_hQpt
foretells	foretold	f$tElz	f$t5ld
bludgeon	bludgeoned	blV_@n	blV_@nd
inlays	inlaid	Inl1z	Inl1d
puckers	puckered	pVk@z	pVk@d
humble	humbled	hVmbP	hVmbPd
mints	minted	mInts	mIntId
looks	looked	lUks	lUkt
excommunicate	excommunicated	"Eksk@mjunIk1t	"Eksk@mjunIk1tId
coddles	coddled	kQdPz	kQdPd
recalls	recalled	rIk$lz	rIk$ld
profanes	profaned	pr@f1nz	pr@f1nd
regiments	regimented	rE_ImEnts	rE_ImEntId
informs	informed	Inf$mz	Inf$md
waters	watered	w$t@z	w$t@d
retreats	retreated	rItrits	rItritId
congest	congested	k@n_Est	k@n_EstId
brave	braved	br1v	br1vd
resents	resented	rIzEnts	rIzEntId
chauffeur	chauffeured	S5f@R	S5f@d
reface	refaced	"rif1s	"rif1st
climbs	climbed	kl2mz	kl2md
proliferates	proliferated	pr5lIf@r1ts	pr5lIf@r1tId
debilitate	debilitated	dIbIlIt1t	dIbIlIt1tId
foot	footed	fUt	fUtId
lose	lost	luz	lQst
enchant	enchanted	InJ#nt	InJ#ntId
accentuates	accentuated	{ksEntjU1ts	{ksEntjU1tId
predominate	predominated	prIdQmIn1t	prIdQmIn1tId
cover	covered	kVv@R	kVv@d
buttons	buttoned	bVtHz	bVtHd
irritate	irritated	IrIt1t	IrIt1tId
hydrate	hydrated	h2dr1t	h2dr1tId
axe	axed	{ks	{kst
ad-libs	ad-libbed	"{dlIbz	"{dlIbd
grooves	grooved	gruvz	gruvd
withdraws	withdrew	wIDdr$z	wIDdru
interact	interacted	"Int@r{kt	"Int@r{ktId
crowns	crowned	kr6nz	kr6nd
finds	found	f2ndz	f6nd
check	checked	JEk	JEkt
eviscerates	eviscerated	IvIs@r1ts	IvIs@r1tId
square	squared	skw8R	skw8d
educates	educated	E_Uk1ts	E_Uk1tId
tamp	tamped	t{mp	t{mpt
stitches	stitched	stIJIz	stIJt
vend	vended	vEnd	vEndId
thrusts	thrust	TrVsts	TrVst
salaams	salaamed	s@l#mz	s@l#md
stitches	stitched	stIJIz	stIJt
limit	limited	lImIt	lImItId
bounds	bounded	b6ndz	b6ndId
obliterates	obliterated	@blIt@r1ts	@blIt@r1tId
slam	slammed	sl{m	sl{md
denote	denoted	dIn5t	dIn5tId
obsesses	obsessed	@bsEsIz	@bsEst
blooms	bloomed	blumz	blumd
behave	behaved	bIh1v	bIh1vd
safeguards	safeguarded	s1fg#dz	s1fg#dId
burkes	burked	b3ks	b3kt
debauch	debauched	dIb$J	dIb$Jt
salaam	salaamed	s@l#m	s@l#md
trust	trusted	trVst	trVstId
slosh	sloshed	slQS	slQSt
renounce	renounced	rIn6ns	rIn6nst
creams	creamed	krimz	krimd
zones	zoned	z5nz	z5nd
denounces	denounced	dIn6nsIz	dIn6nst
preview	previewed	privju	privjud
clear	cleared	kl7R	kl7d
clashes	clashed	kl{SIz	kl{St
orients	oriented	$r7nts	$r7ntId
cripples	crippled	krIpPz	krIpPd
baby-sit	baby-sat	b1bI"sIt	b1bI"s{t
obsess	obsessed	@bsEs	@bsEst
travels	travelled	tr{vPz	tr{vPd
mollycoddle	mollycoddled	mQlI"kQdP	mQlI"kQdPd
slide	slid	sl2d	slId
lean	leant	lin	lEnt
sketches	sketched	skEJIz	skEJt
slew	slewed	slu	slud
translates	translated	tr{nsl1ts	tr{nsl1tId
induct	inducted	IndVkt	IndVktId
entrap	entrapped	Intr{p	Intr{pt
factors	factored	f{kt@z	f{kt@d
sinks	sank	sINks	s{Nk
rewards	rewarded	rIw$dz	rIw$dId
manage	managed	m{nI_	m{nI_d
alarm	alarmed	@l#m	@l#md
unwind	unwound	"Vnw2nd	"Vnw6nd
convulses	convulsed	k@nvVlsIz	k@nvVlst
secure	secured	sIkj9R	sIkj9d
voyages	voyaged	v4I_Iz	v4I_d
seduce	seduced	sIdjus	sIdjust
saws	sawed	s$z	s$d
precipitates	precipitated	prIsIpIt1ts	prIsIpIt1tId
subdue	subdued	s@bdju	s@bdjud
extradites	extradited	Ekstr@d2ts	Ekstr@d2tId
voyage	voyaged	v4I_	v4I_d
perms	permed	p3mz	p3md
hobble	hobbled	hQbP	hQbPd
swans	swanned	swQnz	swQnd
stucco	stuccoed	stVk5	stVk5d
restates	restated	"rist1ts	"rist1tId
undershoots	undershot	"Vnd@Suts	"Vnd@SQt
scratch	scratched	skr{J	skr{Jt
orientates	orientated	$rIEnt1ts	$rIEnt1tId
arbitrate	arbitrated	#bItr1t	#bItr1tId
guess	guessed	gEs	gEst
inducts	inducted	IndVkts	IndVktId
expunges	expunged	IkspVn_Iz	IkspVn_d
travel	travelled	tr{vP	tr{vPd
eddy	eddied	EdI	EdId
deduce	deduced	dIdjus	dIdjust
puts	put	pUts	pUt
stereotypes	stereotyped	st7r7t2ps	st7r7t2pt
peer	peered	p7R	p7d
scribble	scribbled	skrIbP	skrIbPd
fit	fit	fIt	fIt
gutter	guttered	gVt@R	gVt@d
fling	flung	flIN	flVN
tacks	tacked	t{ks	t{kt
proscribes	proscribed	pr5skr2bz	pr5skr2bd
rehashes	rehashed	"rih{SIz	"rih{St
silence	silenced	s2l@ns	s2l@nst
detail	detailed	dit1l	dit1ld
transfers	transferred	tr{nsf3z	tr{nsf3d
concur	concurred	k@nk3R	k@nk3d
trigger	triggered	trIg@R	trIg@d
shrugs	shrugged	SrVgz	SrVgd
migrate	migrated	m2gr1t	m2gr1tId
befuddle	befuddled	bIfVdP	bIfVdPd
rubberizes	rubberized	rVb@r2zIz	rVb@r2zd
outline	outlined	6tl2n	6tl2nd
interdict	interdicted	"Int@dIkt	"Int@dIktId
hassle	hassled	h{sP	h{sPd
upend	upended	VpEnd	VpEndId
burgle	burgled	b3gP	b3gPd
exhibits	exhibited	IgzIbIts	IgzIbItId
integrate	integrated	IntIgr1t	IntIgr1tId
replaces	replaced	rIpl1sIz	rIpl1st
panic	panicked	p{nIk	p{nIkt
disabuse	disabused	"dIs@bjuz	"dIs@bjuzd
kills	killed	kIlz	kIld
finger	fingered	fINg@R	fINg@d
negotiates	negotiated	nIg5SI1ts	nIg5SI1tId
detect	detected	dItEkt	dItEktId
humbles	humbled	hVmbPz	hVmbPd
surveys	surveyed	s@v1z	s@v1d
notify	notified	n5tIf2	n5tIf2d
swab	swabbed	swQb	swQbd
pitchfork	pitchforked	pIJf$k	pIJf$kt
constitutes	constituted	kQnstItjuts	kQnstItjutId
elope	eloped	Il5p	Il5pt
motorizes	motorized	m5t@r2zIz	m5t@r2zd
rekindle	rekindled	"rikIndP	"rikIndPd
nurses	nursed	n3sIz	n3st
expel	expelled	IkspEl	IkspEld
participate	participated	p#tIsIp1t	p#tIsIp1tId
lute	luted	lut	lutId
call	called	k$l	k$ld
dusts	dusted	dVsts	dVstId
sits	sat	sIts	s{t
differs	differed	dIf@z	dIf@d
chair	chaired	J8R	J8d
toll	tolled	t5l	t5ld
breed	bred	brid	brEd
interfere	interfered	"Int@f7R	"Int@f7d
wars	warred	w$z	w$d
chart	charted	J#t	J#tId
lend	lent	lEnd	lEnt
affects	affected	@fEkts	@fEktId
tremble	trembled	trEmbP	trEmbPd
validates	validated	v{lId1ts	v{lId1tId
precipitate	precipitated	prIsIpIt1t	prIsIpIt1tId
remarks	remarked	rIm#ks	rIm#kt
cavorts	cavorted	k@v$ts	k@v$tId
consent	consented	k@nsEnt	k@nsEntId
fumigates	fumigated	fjumIg1ts	fjumIg1tId
ails	ailed	1lz	1ld
ceases	ceased	sisIz	sist
frequent	frequented	frIkwEnt	frIkwEntId
wantons	wantoned	wQnt@nz	wQnt@nd
pack	packed	p{k	p{kt
hedgehop	hedgehopped	hE_hQp	hE_hQpt
previews	previewed	privjuz	privjud
refract	refracted	rIfr{kt	rIfr{ktId
loads	loaded	l5dz	l5dId
severs	severed	sEv@z	sEv@d
rumples	rumpled	rVmpPz	rVmpPd
scrape	scraped	skr1p	skr1pt
degauss	degaussed	"dig6s	"dig6st
imagine	imagined	Im{_In	Im{_Ind
reward	rewarded	rIw$d	rIw$dId
conserves	conserved	k@ns3vz	k@ns3vd
expostulate	expostulated	IkspQsJUl1t	IkspQsJUl1tId
desalinize	desalinized	"dis{lIn2z	"dis{lIn2zd
faze	fazed	f1z	f1zd
cite	cited	s2t	s2tId
rip	ripped	rIp	rIpt
sow	sowed	s5	s5d
bates	bated	b1ts	b1tId
shortens	shortened	S$tHz	S$tHd
bank	banked	b{Nk	b{Nkt
vanish	vanished	v{nIS	v{nISt
pong	ponged	pQN	pQNd
padlock	padlocked	p{dlQk	p{dlQkt
dun	dunned	dVn	dVnd
cares	cared	k8z	k8d
wanders	wandered	wQnd@z	wQnd@d
misinform	misinformed	"mIsInf$m	"mIsInf$md
cohere	cohered	k5h7R	k5h7d
hallmarks	hallmarked	h$lm#ks	h$lm#kt
enplane	enplaned	Inpl1n	Inpl1nd
slenderizes	slenderized	slEnd@r2zIz	slEnd@r2zd
sublets	sublet	"sVblEts	"sVblEt
achieve	achieved	@Jiv	@Jivd
braves	braved	br1vz	br1vd
triple	tripled	trIpP	trIpPd
attaches	attached	@t{JIz	@t{Jt
pirate	pirated	p2@r@t	p2@r@tId
snarl	snarled	sn#l	sn#ld
scrapes	scraped	skr1ps	skr1pt
chagrins	chagrined	S{grInz	S{grInd
concern	concerned	k@ns3n	k@ns3nd
benefices	beneficed	bEnIfIsIz	bEnIfIst
quip	quipped	kwIp	kwIpt
shy	shied	S2	S2d
outtalk	outtalked	"6tt$k	"6tt$kt
flinches	flinched	flInJIz	flInJt
haunts	haunted	h$nts	h$ntId
prohibit	prohibited	pr@hIbIt	pr@hIbItId
overdo	overdid	"5v@du	"5v@dId
attest	attested	@tEst	@tEstId
advises	advised	@dv2zIz	@dv2zd
apostatize	apostatized	@pQst@t2z	@pQst@t2zd
tinctures	tinctured	tINkJ@z	tINkJ@d
hangs	hung	h{Nz	hVN
liberate	liberated	lIb@r1t	lIb@r1tId
amplifies	amplified	{mplIf2z	{mplIf2d
mops	mopped	mQps	mQpt
misreport	misreported	"mIsrIp$t	"mIsrIp$tId
cherishes	cherished	JErISIz	JErISt
sympathize	sympathized	sImp@T2z	sImp@T2zd
sustains	sustained	s@st1nz	s@st1nd
cleanses	cleansed	klEnzIz	klEnzd
scats	scatted	sk{ts	sk{tId
fondles	fondled	fQndPz	fQndPd
mobilizes	mobilized	m5bIl2zIz	m5bIl2zd
stuff	stuffed	stVf	stVft
inform	informed	Inf$m	Inf$md
foreshadow	foreshadowed	f$S{d5	f$S{d5d
disproves	disproved	"dIspruvz	"dIspruvd
propose	proposed	pr@p5z	pr@p5zd
let	let	lEt	lEt
distributes	distributed	dIstrIbjuts	dIstrIbjutId
paragraphs	paragraphed	p{r@gr#fs	p{r@gr#ft
founder	foundered	f6nd@R	f6nd@d
adjusts	adjusted	@_Vsts	@_VstId
decompress	decompressed	"dik@mprEs	"dik@mprEst
abolishes	abolished	@bQlISIz	@bQlISt
eddies	eddied	EdIz	EdId
comment	commented	kQmEnt	kQmEntId
owe	owed	5	5d
discover	discovered	dIskVv@R	dIskVv@d
censure	censured	sEnS@R	sEnS@d
inoculates	inoculated	InQkjUl1ts	InQkjUl1tId
cools	cooled	kulz	kuld
scrutinizes	scrutinized	skrutIn2zIz	skrutIn2zd
preach	preached	priJ	priJt
flag	flagged	fl{g	fl{gd
slim	slimmed	slIm	slImd
unsaddle	unsaddled	"Vns{dP	"Vns{dPd
evangelizes	evangelized	Iv{n_@l2zIz	Iv{n_@l2zd
submits	submitted	s@bmIts	s@bmItId
demand	demanded	dIm#nd	dIm#ndId
rouses	roused	r6zIz	r6zd
pressure	pressured	prES@R	prES@d
falls	fell	f$lz	fEl
belittle	belittled	bIlItP	bIlItPd
indicates	indicated	IndIk1ts	IndIk1tId
ramify	ramified	r{mIf2	r{mIf2d
blindfold	blindfolded	bl2ndf5ld	bl2ndf5ldId
beseem	beseemed	bIsim	bIsimd
jerks	jerked	_3ks	_3kt
excommunicates	excommunicated	"Eksk@mjunIk1ts	"Eksk@mjunIk1tId
pontificate	pontificated	pQntIfIk1t	pQntIfIk1tId
censors	censored	sEns@z	sEns@d
comments	commented	kQmEnts	kQmEntId
narrows	narrowed	n{r5z	n{r5d
empanel	empanelled	Imp{nP	Imp{nPd
awaits	awaited	@w1ts	@w1tId
overdoes	overdid	"5v@dVz	"5v@dId
quit	quit	kwIt	kwIt
intercalate	intercalated	Int3k@l1t	Int3k@l1tId
savage	savaged	s{vI_	s{vI_d
penetrate	penetrated	pEnItr1t	pEnItr1tId
endure	endured	Indj9R	Indj9d
zooms	zoomed	zumz	zumd
strive	strove	str2v	str5v
mess	messed	mEs	mEst
appreciates	appreciated	@priSI1ts	@priSI1tId
scribes	scribed	skr2bz	skr2bd
perch	perched	p3J	p3Jt
contrast	contrasted	k@ntr#st	k@ntr#stId
prohibits	prohibited	pr@hIbIts	pr@hIbItId
powwows	powwowed	p6w6z	p6w6d
sprays	sprayed	spr1z	spr1d
mum	mummed	mVm	mVmd
abstain	abstained	@bst1n	@bst1nd
attack	attacked	@t{k	@t{kt
responds	responded	rIspQndz	rIspQndId
feasts	feasted	fists	fistId
travesty	travestied	tr{v@stI	tr{v@stId
perforate	perforated	p3f@r1t	p3f@r1tId
obtrudes	obtruded	@btrudz	@btrudId
fricassees	fricasseed	"frIk@siz	"frIk@sid
deodorize	deodorized	di5d@r2z	di5d@r2zd
inhale	inhaled	Inh1l	Inh1ld
tempts	tempted	tEmpts	tEmptId
consume	consumed	k@nsjum	k@nsjumd
sound	sounded	s6nd	s6ndId
aid	aided	1d	1dId
allies	allied	@l2z	@l2d
annotates	annotated	{n5t1ts	{n5t1tId
gloss	glossed	glQs	glQst
heap	heaped	hip	hipt
bath	bathed	b#T	b1Dd
titillates	titillated	tItIl1ts	tItIl1tId
mingles	mingled	mINgPz	mINgPd
contrasts	contrasted	k@ntr#sts	k@ntr#stId
dispirit	dispirited	dIspIrIt	dIspIrItId
inaugurate	inaugurated	In$gjUr1t	In$gjUr1tId
scribes	scribed	skr2bz	skr2bd
hurries	hurried	hVrIz	hVrId
cavort	cavorted	k@v$t	k@v$tId
survey	surveyed	s@v1	s@v1d
tenants	tenanted	tEn@nts	tEn@ntId
arrive	arrived	@r2v	@r2vd
arrest	arrested	@rEst	@rEstId
starch	starched	st#J	st#Jt
contributes	contributed	k@ntrIbjuts	k@ntrIbjutId
may	might	m1	m2t
chances	chanced	J#nsIz	J#nst
decrease	decreased	dikris	dikrist
disarms	disarmed	dIs#mz	dIs#md
prays	prayed	pr1z	pr1d
dismembers	dismembered	dIsmEmb@z	dIsmEmb@d
palls	palled	p$lz	p$ld
regard	regarded	rIg#d	rIg#dId
confront	confronted	k@nfrVnt	k@nfrVntId
swallow	swallowed	swQl5	swQl5d
swoops	swooped	swups	swupt
twinkles	twinkled	twINkPz	twINkPd
hopes	hoped	h5ps	h5pt
repudiate	repudiated	rIpjudI1t	rIpjudI1tId
cosset	cosseted	kQsIt	kQsItId
crawls	crawled	kr$lz	kr$ld
motor	motored	m5t@R	m5t@d
emancipate	emancipated	Im{nsIp1t	Im{nsIp1tId
interns	interned	Int3nz	Int3nd
jaywalks	jaywalked	_1w$ks	_1w$kt
shambles	shambled	S{mbPz	S{mbPd
thrives	throve	Tr2vz	Tr5v
ends	ended	Endz	EndId
squeak	squeaked	skwik	skwikt
interrupt	interrupted	"Int@rVpt	"Int@rVptId
occupy	occupied	QkjUp2	QkjUp2d
learn	learnt	l3n	l3nt
scribbles	scribbled	skrIbPz	skrIbPd
damns	damned	d{mz	d{md
dejects	dejected	dI_Ekts	dI_EktId
wench	wenched	wEnJ	wEnJt
join	joined	_4n	_4nd
retreat	retreated	rItrit	rItritId
cures	cured	kj9z	kj9d
butts	butted	bVts	bVtId
crates	crated	kr1ts	kr1tId
knows	knew	n5z	nju
initials	initialled	InISPz	InISPd
stimulates	stimulated	stImjUl1ts	stImjUl1tId
enters	entered	Ent@z	Ent@d
rut	rutted	rVt	rVtId
gleams	gleamed	glimz	glimd
veneers	veneered	v@n7z	v@n7d
vilifies	vilified	vIlIf2z	vIlIf2d
articles	articled	#tIkPz	#tIkPd
flop	flopped	flQp	flQpt
deep-freezes	deep-froze	"dipfrizIz	"dipfr5z
battle	battled	b{tP	b{tPd
furnish	furnished	f3nIS	f3nISt
speaks	spoke	spiks	sp5k
cleaves	clove	klivz	kl5v
lace	laced	l1s	l1st
stagnates	stagnated	st{gn1ts	st{gn1tId
scrabbles	scrabbled	skr{bPz	skr{bPd
xeroxes	xeroxed	z7rQksIz	z7rQkst
curve	curved	k3v	k3vd
rights	righted	r2ts	r2tId
forswears	forswore	f$sw8z	f$sw$R
departs	departed	dIp#ts	dIp#tId
transmigrate	transmigrated	"tr{nzm2gr1t	"tr{nzm2gr1tId
checks	checked	JEks	JEkt
goof	goofed	guf	guft
woolgather	woolgathered	wUl"g{D@R	wUl"g{D@d
respites	respited	rEsp2ts	rEsp2tId
complains	complained	k@mpl1nz	k@mpl1nd
mollycoddles	mollycoddled	mQlI"kQdPz	mQlI"kQdPd
whips	whipped	wIps	wIpt
chagrin	chagrined	S{grIn	S{grInd
charter	chartered	J#t@R	J#t@d
conform	conformed	k@nf$m	k@nf$md
castle	castled	k#sP	k#sPd
sell	sold	sEl	s5ld
operate	operated	Qp@r1t	Qp@r1tId
outfight	outfought	6tf2t	6tf$t
bottle-feed	bottle-fed	bQtPfid	bQtPfEd
draw	drew	dr$	dru
brags	bragged	br{gz	br{gd
aim	aimed	1m	1md
ail	ailed	1l	1ld
crumbles	crumbled	krVmbPz	krVmbPd
boosts	boosted	busts	bustId
skips	skipped	skIps	skIpt
redirect	redirected	"ridIrEkt	"ridIrEktId
vary	varied	v8rI	v8rId
decelerates	decelerated	"disEl@r1ts	"disEl@r1tId
peach	peached	piJ	piJt
clock	clocked	klQk	klQkt
defuses	defused	"difjuzIz	"difjuzd
blacken	blackened	bl{k@n	bl{k@nd
grabs	grabbed	gr{bz	gr{bd
profiles	profiled	pr5f2lz	pr5f2ld
masterminds	masterminded	m#st@m2ndz	m#st@m2ndId
witnesses	witnessed	wItnIsIz	wItnIst
heighten	heightened	h2tH	h2tHd
belies	belied	bIl2z	bIl2d
pervades	pervaded	p@v1dz	p@v1dId
function	functioned	fVNkSH	fVNkSHd
irritates	irritated	IrIt1ts	IrIt1tId
fear	feared	f7R	f7d
oversell	oversold	"5v@sEl	"5v@s5ld
fragments	fragmented	fr{gmEnts	fr{gmEntId
approves	approved	@pruvz	@pruvd
transmit	transmitted	tr{nzmIt	tr{nzmItId
traffics	trafficked	tr{fIks	tr{fIkt
undertakes	undertook	"Vnd@t1ks	"Vnd@tuk
conquers	conquered	kQNk@z	kQNk@d
flees	fled	fliz	flEd
crimps	crimped	krImps	krImpt
delegate	delegated	dElIg1t	dElIg1tId
excite	excited	Iks2t	Iks2tId
saturates	saturated	s{J@r1ts	s{J@r1tId
blabs	blabbed	bl{bz	bl{bd
cram	crammed	kr{m	kr{md
date	dated	d1t	d1tId
crumble	crumbled	krVmbP	krVmbPd
infers	inferred	Inf3z	Inf3d
scoff	scoffed	skQf	skQft
bicycles	bicycled	b2sIkPz	b2sIkPd
prints	printed	prInts	prIntId
betrays	betrayed	bItr1z	bItr1d
leaps	lope	lips	l5p
apostatizes	apostatized	@pQst@t2zIz	@pQst@t2zd
impart	imparted	Imp#t	Imp#tId
aids	aided	1dz	1dId
rebel	rebelled	rIbEl	rIbEld
pardons	pardoned	p#dHz	p#dHd
pester	pestered	pEst@R	pEst@d
tie-dye	tie-dyed	t2d2	t2d2d
undoes	undid	"VndVz	"VndId
scram	scrammed	skr{m	skr{md
pressurize	pressurized	prES@r2z	prES@r2zd
stretches	stretched	strEJIz	strEJt
watches	watched	wQJIz	wQJt
justifies	justified	_VstIf2z	_VstIf2d
disfigures	disfigured	dIsfIg@z	dIsfIg@d
rat	ratted	r{t	r{tId
jaywalk	jaywalked	_1w$k	_1w$kt
disafforest	disafforested	"dIs@fQrIst	"dIs@fQrIstId
ramifies	ramified	r{mIf2z	r{mIf2d
hallucinate	hallucinated	h@lusIn1t	h@lusIn1tId
secularizes	secularized	sEkjUl@r2zIz	sEkjUl@r2zd
centralizes	centralized	sEntr@l2zIz	sEntr@l2zd
approve	approved	@pruv	@pruvd
ploughs	ploughed	pl6z	pl6d
dunks	dunked	dVNks	dVNkt
ferry	ferried	fErI	fErId
conceptualizes	conceptualized	k@nsEpJ9l2zIz	k@nsEpJ9l2zd
makes	made	m1ks	m1d
stalemates	stalemated	st1lm1ts	st1lm1tId
disappoint	disappointed	"dIs@p4nt	"dIs@p4ntId
lutes	luted	luts	lutId
jinx	jinxed	_INks	_INkst
conceives	conceived	k@nsivz	k@nsivd
postpones	postponed	"p5stp5nz	"p5stp5nd
wastes	wasted	w1sts	w1stId
stay	stayed	st1	st1d
spellbinds	spellbound	spElb2ndz	spElb6nd
patronize	patronized	p{tr@n2z	p{tr@n2zd
scandalizes	scandalized	sk{nd@l2zIz	sk{nd@l2zd
discriminates	discriminated	dIskrImIn1ts	dIskrImIn1tId
craze	crazed	kr1z	kr1zd
contract	contracted	k@ntr{kt	k@ntr{ktId
lament	lamented	l@mEnt	l@mEntId
disjoint	disjointed	dIs_4nt	dIs_4ntId
shields	shielded	Sildz	SildId
gift	gifted	gIft	gIftId
clams	clammed	kl{mz	kl{md
nobbles	nobbled	nQbPz	nQbPd
slash	slashed	sl{S	sl{St
countermarches	countermarched	k6nt@m#JIz	k6nt@m#Jt
swears	swore	sw8z	sw$R
fusses	fussed	fVsIz	fVst
steep	steeped	stip	stipt
phone	phoned	f5n	f5nd
thrum	thrummed	TrVm	TrVmd
finishes	finished	fInISIz	fInISt
flails	flailed	fl1lz	fl1ld
affect	affected	@fEkt	@fEktId
profane	profaned	pr@f1n	pr@f1nd
renege	reneged	rInig	rInigd
axe	axed	{ks	{kst
vilify	vilified	vIlIf2	vIlIf2d
oppose	opposed	@p5z	@p5zd
certificates	certificated	s@tIfIk1ts	s@tIfIk1tId
rock	rocked	rQk	rQkt
sentences	sentenced	sEnt@nsIz	sEnt@nst
abandon	abandoned	@b{nd@n	@b{nd@nd
overcapitalize	overcapitalized	"5v@k{pIt@l2z	"5v@k{pIt@l2zd
cross	crossed	krQs	krQst
reorganize	reorganized	"ri$g@n2z	"ri$g@n2zd
plummet	plummetted	plVmIt	plVmItId
supply	supplied	s@pl2	s@pl2d
drags	drug	dr{gz	drVg
squawks	squawked	skw$ks	skw$kt
behold	beheld	bIh5ld	bIhEld
conforms	conformed	k@nf$mz	k@nf$md
boost	boosted	bust	bustId
revives	revived	rIv2vz	rIv2vd
bike	biked	b2k	b2kt
cheek	cheeked	Jik	Jikt
build	built	bIld	bIlt
incurs	incurred	Ink3z	Ink3d
wage	waged	w1_	w1_d
enriches	enriched	InrIJIz	InrIJt
clarifies	clarified	kl{rIf2z	kl{rIf2d
reels	reeled	rilz	rild
tease	teased	tiz	tizd
vamp	vamped	v{mp	v{mpt
fails	failed	f1lz	f1ld
enjoin	enjoined	In_4n	In_4nd
circumnavigate	circumnavigated	"s3k@mn{vIg1t	"s3k@mn{vIg1tId
syndicate	syndicated	sIndIk1t	sIndIk1tId
massage	massaged	m{s#Z	m{s#Zd
filches	filched	fIlJIz	fIlJt
disconnect	disconnected	"dIsk@nEkt	"dIsk@nEktId
rehearse	rehearsed	rIh3s	rIh3st
train	trained	tr1n	tr1nd
receipts	receipted	rIsits	rIsitId
efface	effaced	If1s	If1st
guard	guarded	g#d	g#dId
open	opened	5p@n	5p@nd
inspire	inspired	Insp2@R	Insp2@d
correspond	corresponded	"kQrIspQnd	"kQrIspQndId
profit	profited	prQfIt	prQfItId
launder	laundered	l$nd@R	l$nd@d
chokes	choked	J5ks	J5kt
sleek	sleeked	slik	slikt
debilitates	debilitated	dIbIlIt1ts	dIbIlIt1tId
disfrocks	disfrocked	"dIsfrQks	"dIsfrQkt
protect	protected	pr@tEkt	pr@tEktId
deteriorate	deteriorated	dIt7r7r1t	dIt7r7r1tId
turn	turned	t3n	t3nd
tarnish	tarnished	t#nIS	t#nISt
greets	greeted	grits	gritId
leers	leered	l7z	l7d
quaffs	quaffed	kwQfs	kwQft
nobble	nobbled	nQbP	nQbPd
deposit	deposited	dIpQzIt	dIpQzItId
yawns	yawned	j$nz	j$nd
postdate	postdated	"p5std1t	"p5std1tId
convolve	convolved	k@nvQlv	k@nvQlvd
incur	incurred	Ink3R	Ink3d
personify	personified	p@sQnIf2	p@sQnIf2d
trace	traced	tr1s	tr1st
avoids	avoided	@v4dz	@v4dId
railroads	railroaded	r1lr5dz	r1lr5dId
avow	avowed	@v6	@v6d
comprises	comprised	k@mpr2zIz	k@mpr2zd
eludes	eluded	Iludz	IludId
immures	immured	Imj9z	Imj9d
surprise	surprised	s@pr2z	s@pr2zd
deputes	deputed	dIpjuts	dIpjutId
sucks	sucked	sVks	sVkt
bills	billed	bIlz	bIld
decelerate	decelerated	"disEl@r1t	"disEl@r1tId
overcome	overcame	"5v@kVm	"5v@k1m
caresses	caressed	k@rEsIz	k@rEst
relives	relived	"rilIvz	"rilIvd
unlock	unlocked	"VnlQk	"VnlQkt
gels	gelled	_Elz	_Eld
hamstrings	hamstrung	h{mstrINz	h{mstrVN
disembowels	disembowelled	"dIsImb6@lz	"dIsImb6@ld
prejudice	prejudiced	prE_UdIs	prE_UdIst
deodorize	deodorized	di5d@r2z	di5d@r2zd
tin	tinned	tIn	tInd
immolates	immolated	Im5l1ts	Im5l1tId
brainwash	brainwashed	br1nwQS	br1nwQSt
wheedles	wheedled	widPz	widPd
couches	couched	k6JIz	k6Jt
button	buttoned	bVtH	bVtHd
enrich	enriched	InrIJ	InrIJt
prohibit	prohibited	pr@hIbIt	pr@hIbItId
alienate	alienated	1lj@n1t	1lj@n1tId
baths	bathed	b#Ts	b1Dd
lies	lied	l2z	l2d
creates	created	kri1ts	kri1tId
contests	contested	k@ntEsts	k@ntEstId
bivouacs	bivouacked	bIvU{ks	bIvU{kt
reafforest	reafforested	"ri@fQrIst	"ri@fQrIstId
convoy	convoyed	kQnv4	kQnv4d
dust	dusted	dVst	dVstId
unpick	unpicked	"VnpIk	"VnpIkt
wangle	wangled	w{NgP	w{NgPd
dock	docked	dQk	dQkt
rewords	reworded	"riw3dz	"riw3dId
parade	paraded	p@r1d	p@r1dId
squeezes	squeezed	skwizIz	skwizd
quotes	quoted	kw5ts	kw5tId
intercepts	intercepted	"Int@sEpts	"Int@sEptId
fag	fagged	f{g	f{gd
crazes	crazed	kr1zIz	kr1zd
romp	romped	rQmp	rQmpt
sanction	sanctioned	s{NkSH	s{NkSHd
airdrop	airdropped	8drQp	8drQpt
facilitates	facilitated	f@sIlIt1ts	f@sIlIt1tId
gulp	gulped	gVlp	gVlpt
pressurizes	pressurized	prES@r2zIz	prES@r2zd
scandalize	scandalized	sk{nd@l2z	sk{nd@l2zd
collars	collared	kQl@z	kQl@d
deplete	depleted	dIplit	dIplitId
commit	committed	k@mIt	k@mItId
chooses	chose	JuzIz	J5z
enplanes	enplaned	Inpl1nz	Inpl1nd
honour	honoured	Qn@R	Qn@d
hash	hashed	h{S	h{St
jostles	jostled	_QsPz	_QsPd
solace	solaced	sQl@s	sQl@st
belt	belted	bElt	bEltId
palm	palmed	p#m	p#md
seine	seined	s1n	s1nd
crates	crated	kr1ts	kr1tId
draws	drew	dr$z	dru
sort	sorted	s$t	s$tId
hooks	hooked	hUks	hUkt
immunize	immunized	Imjun2z	Imjun2zd
inhale	inhaled	Inh1l	Inh1ld
gifts	gifted	gIfts	gIftId
bursts	burst	b3sts	b3st
trump	trumped	trVmp	trVmpt
silences	silenced	s2l@nsIz	s2l@nst
envelops	enveloped	InvEl@ps	InvEl@pt
debunks	debunked	"dibVNks	"dibVNkt
scrimmage	scrimmaged	skrImI_	skrImI_d
excuse	excused	Ikskjuz	Ikskjuzd
beatifies	beatified	bi{tIf2z	bi{tIf2d
exude	exuded	Igzjud	IgzjudId
oxygenizes	oxygenized	QksI_@n2zIz	QksI_@n2zd
canalize	canalized	k{n@l2z	k{n@l2zd
averts	averted	@v3ts	@v3tId
inconveniences	inconvenienced	"Ink@nvinj@nsIz	"Ink@nvinj@nst
resent	resented	rIzEnt	rIzEntId
thwack	thwacked	Tw{k	Tw{kt
season	seasoned	sizH	sizHd
glance	glanced	gl#ns	gl#nst
outfights	outfought	6tf2ts	6tf$t
honours	honoured	Qn@z	Qn@d
rush	rushed	rVS	rVSt
stomps	stomped	stQmps	stQmpt
disposes	disposed	dIsp5zIz	dIsp5zd
machines	machined	m@Sinz	m@Sind
respite	respited	rEsp2t	rEsp2tId
purrs	purred	p3z	p3d
groan	groaned	gr5n	gr5nd
outfoxes	outfoxed	6tfQksIz	6tfQkst
enlarges	enlarged	Inl#_Iz	Inl#_d
quadruples	quadrupled	kwQdrUpPz	kwQdrUpPd
resumes	resumed	rIzjumz	rIzjumd
memorialize	memorialized	m@m$r7l2z	m@m$r7l2zd
disapproves	disapproved	"dIs@pruvz	"dIs@pruvd
subdues	subdued	s@bdjuz	s@bdjud
gargle	gargled	g#gP	g#gPd
burlesques	burlesqued	b3lEsks	b3lEskt
attempt	attempted	@tEmpt	@tEmptId
interbreeds	interbred	"Int@bridz	"Int@brEd
soundproof	soundproofed	s6ndpruf	s6ndpruft
delineates	delineated	dIlInI1ts	dIlInI1tId
yells	yelled	jElz	jEld
exhorts	exhorted	Igz$ts	Igz$tId
postpone	postponed	"p5stp5n	"p5stp5nd
blows	blew	bl5z	blu
polarize	polarized	p5l@r2z	p5l@r2zd
juggle	juggled	_VgP	_VgPd
forbids	forbid	f@bIdz	f@bId
unbalance	unbalanced	"Vnb{l@ns	"Vnb{l@nst
consigns	consigned	k@ns2nz	k@ns2nd
card	carded	k#d	k#dId
telephone	telephoned	tElIf5n	tElIf5nd
state	stated	st1t	st1tId
switch	switched	swIJ	swIJt
tolerate	tolerated	tQl@r1t	tQl@r1tId
estranges	estranged	Istr1n_Iz	Istr1n_d
stride	strode	str2d	str5d
files	filed	f2lz	f2ld
pin	pinned	pIn	pInd
stalemate	stalemated	st1lm1t	st1lm1tId
debits	debited	dEbIts	dEbItId
acquire	acquired	@kw2@R	@kw2@d
vouchsafes	vouchsafed	v6Js1fs	v6Js1ft
march	marched	m#J	m#Jt
slams	slammed	sl{mz	sl{md
conglomerates	conglomerated	k@nglQm@r1ts	k@nglQm@r1tId
assigns	assigned	@s2nz	@s2nd
decipher	deciphered	dIs2f@R	dIs2f@d
off-load	off-loaded	"Qfl5d	"Qfl5dId
criticizes	criticized	krItIs2zIz	krItIs2zd
teaches	taught	tiJIz	t$t
sense	sensed	sEns	sEnst
prink	prinked	prINk	prINkt
concerns	concerned	k@ns3nz	k@ns3nd
diverts	diverted	d2v3ts	d2v3tId
clinch	clinched	klInJ	klInJt
entrenches	entrenched	IntrEnJIz	IntrEnJt
balloon	ballooned	b@lun	b@lund
fur	furred	f3R	f3d
pokes	poked	p5ks	p5kt
chinks	chinked	JINks	JINkt
conceal	concealed	k@nsil	k@nsild
mould	moulded	m5ld	m5ldId
grumble	grumbled	grVmbP	grVmbPd
inhabit	inhabited	Inh{bIt	Inh{bItId
surrenders	surrendered	s@rEnd@z	s@rEnd@d
spades	spaded	sp1dz	sp1dId
hinders	hindered	hInd@z	hInd@d
succeeds	succeeded	s@ksidz	s@ksidId
miff	miffed	mIf	mIft
arranges	arranged	@r1n_Iz	@r1n_d
initiates	initiated	InISI1ts	InISI1tId
reafforests	reafforested	"ri@fQrIsts	"ri@fQrIstId
foreknow	foreknew	f$n5	f$nju
preconceives	preconceived	"prik@nsivz	"prik@nsivd
enounce	enounced	in6ns	in6nst
daub	daubed	d$b	d$bd
underbid	underbid	"Vnd@bId	"Vnd@bId
yellows	yellowed	jEl5z	jEl5d
bucket	bucketed	bVkIt	bVkItId
solve	solved	sQlv	sQlvd
pocket	pocketed	pQkIt	pQkItId
libels	libelled	l2bPz	l2bPd
gathers	gathered	g{D@z	g{D@d
undermines	undermined	"Vnd@m2nz	"Vnd@m2nd
purposes	purposed	p3p@sIz	p3p@st
compartmentalizes	compartmentalized	"kQmp#tmEntP2zIz	"kQmp#tmEntP2zd
refuse	refused	rIfjuz	rIfjuzd
recruit	recruited	rIkrut	rIkrutId
clank	clanked	kl{Nk	kl{Nkt
crackle	crackled	kr{kP	kr{kPd
market	marketed	m#kIt	m#kItId
outrange	outranged	"6tr1n_	"6tr1n_d
plump	plumped	plVmp	plVmpt
tipples	tippled	tIpPz	tIpPd
gas	gassed	g{s	g{st
polarizes	polarized	p5l@r2zIz	p5l@r2zd
please	pleased	pliz	plizd
bleeds	bled	blidz	blEd
convoys	convoyed	kQnv4z	kQnv4d
answer	answered	#ns@R	#ns@d
factorize	factorized	f{kt@r2z	f{kt@r2zd
fathoms	fathomed	f{D@mz	f{D@md
pressures	pressured	prES@z	prES@d
embodies	embodied	ImbQdIz	ImbQdId
advocates	advocated	{dv@k1ts	{dv@k1tId
scatter	scattered	sk{t@R	sk{t@d
visit	visited	vIzIt	vIzItId
addle	addled	{dP	{dPd
tires	tired	t2@z	t2@d
bomb	bombed	bQm	bQmd
shorten	shortened	S$tH	S$tHd
dispose	disposed	dIsp5z	dIsp5zd
curtain	curtained	k3tH	k3tHd
salivate	salivated	s{lIv1t	s{lIv1tId
stows	stowed	st5z	st5d
erases	erased	Ir1zIz	Ir1zd
blames	blamed	bl1mz	bl1md
delineate	delineated	dIlInI1t	dIlInI1tId
loft	lofted	lQft	lQftId
minds	minded	m2ndz	m2ndId
starts	started	st#ts	st#tId
cross-question	cross-questioned	"krQskwEsJ@n	"krQskwEsJ@nd
contain	contained	k@nt1n	k@nt1nd
outweighs	outweighed	"6tw1z	"6tw1d
discriminate	discriminated	dIskrImIn1t	dIskrImIn1tId
better	bettered	bEt@R	bEt@d
mimeographs	mimeographed	mIm7gr#fs	mIm7gr#ft
withstand	withstood	wIDst{nd	wIDstUd
skewers	skewered	skju@z	skju@d
finish	finished	fInIS	fInISt
compound	compounded	k@mp6nd	k@mp6ndId
install	installed	Inst$l	Inst$ld
relocates	relocated	"ril5k1ts	"ril5k1tId
backbite	backbit	b{kb2t	b{kbIt
box	boxed	bQks	bQkst
withstands	withstood	wIDst{ndz	wIDstUd
neglect	neglected	nIglEkt	nIglEktId
glosses	glossed	glQsIz	glQst
soldiers	soldiered	s5l_@z	s5l_@d
taint	tainted	t1nt	t1ntId
jaunt	jaunted	_$nt	_$ntId
bevels	bevelled	bEvPz	bEvPd
portrays	portrayed	p$tr1z	p$tr1d
intervenes	intervened	"Int@vinz	"Int@vind
smelts	smelted	smElts	smEltId
sloshes	sloshed	slQSIz	slQSt
embarrass	embarrassed	Imb{r@s	Imb{r@st
object	objected	@b_Ekt	@b_EktId
tastes	tasted	t1sts	t1stId
derange	deranged	dIr1n_	dIr1n_d
cut	cut	kVt	kVt
supplicates	supplicated	sVplIk1ts	sVplIk1tId
revitalize	revitalized	"riv2t@l2z	"riv2t@l2zd
mauls	mauled	m$lz	m$ld
disclose	disclosed	dIskl5z	dIskl5zd
musses	mussed	mVsIz	mVst
chant	chanted	J#nt	J#ntId
opines	opined	5p2nz	5p2nd
overthrow	overthrew	"5v@Tr5	"5v@Tru
humanize	humanized	hjum@n2z	hjum@n2zd
disperses	dispersed	dIsp3sIz	dIsp3st
inoculate	inoculated	InQkjUl1t	InQkjUl1tId
freeze-dry	freeze-dried	"frizdr2	"frizdr2d
boxes	boxed	bQksIz	bQkst
games	gamed	g1mz	g1md
fish	fished	fIS	fISt
launches	launched	l$nJIz	l$nJt
applauds	applauded	@pl$dz	@pl$dId
vanishes	vanished	v{nISIz	v{nISt
destroy	destroyed	dIstr4	dIstr4d
knits	knit	nIts	nIt
chase	chased	J1s	J1st
forebodes	foreboded	f$b5dz	f$b5dId
forfeits	forfeited	f$fIts	f$fItId
console	consoled	k@ns5l	k@ns5ld
syncopate	syncopated	sINk@p1t	sINk@p1tId
surmise	surmised	s3m2z	s3m2zd
dictates	dictated	dIkt1ts	dIkt1tId
practises	practised	pr{ktIsIz	pr{ktIst
match	matched	m{J	m{Jt
repress	repressed	rIprEs	rIprEst
outfox	outfoxed	6tfQks	6tfQkst
pulverize	pulverized	pVlv@r2z	pVlv@r2zd
teach	taught	tiJ	t$t
pool	pooled	pul	puld
usher	ushered	VS@R	VS@d
evanesce	evanesced	"iv@nEs	"iv@nEst
ionizes	ionized	2@n2zIz	2@n2zd
flusters	flustered	flVst@z	flVst@d
cradles	cradled	kr1dPz	kr1dPd
shutters	shuttered	SVt@z	SVt@d
objurgate	objurgated	Qb_@g1t	Qb_@g1tId
layer	layered	l1@R	l1@d
risk	risked	rIsk	rIskt
improves	improved	Impruvz	Impruvd
restates	restated	"rist1ts	"rist1tId
dissolve	dissolved	dIzQlv	dIzQlvd
performs	performed	p@f$mz	p@f$md
drown	drowned	dr6n	dr6nd
lambastes	lambasted	l{mb1sts	l{mb1stId
correct	corrected	k@rEkt	k@rEktId
autographs	autographed	$t@gr#fs	$t@gr#ft
feast	feasted	fist	fistId
pursue	pursued	p@sju	p@sjud
occurs	occurred	@k3z	@k3d
chlorinate	chlorinated	kl$rIn1t	kl$rIn1tId
airlifts	airlifted	8lIfts	8lIftId
arises	arose	@r2zIz	@r5z
hurls	hurled	h3lz	h3ld
motor	motored	m5t@R	m5t@d
actuate	actuated	{ktjU1t	{ktjU1tId
romps	romped	rQmps	rQmpt
secularize	secularized	sEkjUl@r2z	sEkjUl@r2zd
sizes	sized	s2zIz	s2zd
overlap	overlapped	"5v@l{p	"5v@l{pt
enshrine	enshrined	InSr2n	InSr2nd
shamble	shambled	S{mbP	S{mbPd
liaise	liaised	lI1z	lI1zd
stomp	stomped	stQmp	stQmpt
report	reported	rIp$t	rIp$tId
stagnate	stagnated	st{gn1t	st{gn1tId
concede	conceded	k@nsid	k@nsidId
mortgages	mortgaged	m$gI_Iz	m$gI_d
quarrels	quarrelled	kwQr@lz	kwQr@ld
raise	raised	r1z	r1zd
satiate	satiated	s1SI1t	s1SI1tId
accompany	accompanied	@kVmp@nI	@kVmp@nId
shoves	shoved	SVvz	SVvd
doctor	doctored	dQkt@R	dQkt@d
conglomerate	conglomerated	k@nglQm@r1t	k@nglQm@r1tId
provoke	provoked	pr@v5k	pr@v5kt
explain	explained	Ikspl1n	Ikspl1nd
dislike	disliked	dIsl2k	dIsl2kt
enforce	enforced	Inf$s	Inf$st
graduate	graduated	gr{djU1t	gr{djU1tId
records	recorded	rIk$dz	rIk$dId
percolate	percolated	p3k@l1t	p3k@l1tId
attenuate	attenuated	@tEnjU1t	@tEnjU1tId
acidulates	acidulated	@sIdjUl1ts	@sIdjUl1tId
defraud	defrauded	dIfr$d	dIfr$dId
vitrifies	vitrified	vItrIf2z	vItrIf2d
salivates	salivated	s{lIv1ts	s{lIv1tId
decapitate	decapitated	dIk{pIt1t	dIk{pIt1tId
smashes	smashed	sm{SIz	sm{St
mimics	mimicked	mImIks	mImIkt
stints	stinted	stInts	stIntId
invokes	invoked	Inv5ks	Inv5kt
presumes	presumed	prIzjumz	prIzjumd
prevent	prevented	prIvEnt	prIvEntId
deploy	deployed	dIpl4	dIpl4d
paragraph	paragraphed	p{r@gr#f	p{r@gr#ft
flood	flooded	flVd	flVdId
deplore	deplored	dIpl$R	dIpl$d
chlorinates	chlorinated	kl$rIn1ts	kl$rIn1tId
dignify	dignified	dIgnIf2	dIgnIf2d
inhales	inhaled	Inh1lz	Inh1ld
outrivals	outrivalled	"6tr2vPz	"6tr2vPd
arrange	arranged	@r1n_	@r1n_d
welcomes	welcomed	wElk@mz	wElk@md
swabs	swabbed	swQbz	swQbd
spank	spanked	sp{Nk	sp{Nkt
degausses	degaussed	"dig6sIz	"dig6st
accumulates	accumulated	@kjumjUl1ts	@kjumjUl1tId
represents	represented	"rEprIzEnts	"rEprIzEntId
intervene	intervened	"Int@vin	"Int@vind
nosedive	nosedived	n5zd2v	n5zd2vd
receipts	receipted	rIsits	rIsitId
encamps	encamped	Ink{mps	Ink{mpt
trammels	trammelled	tr{mPz	tr{mPd
mimic	mimicked	mImIk	mImIkt
stultifies	stultified	stVltIf2z	stVltIf2d
hunts	hunted	hVnts	hVntId
mimeograph	mimeographed	mIm7gr#f	mIm7gr#ft
forebode	foreboded	f$b5d	f$b5dId
ally	allied	@l2	@l2d
recites	recited	rIs2ts	rIs2tId
squawk	squawked	skw$k	skw$kt
align	aligned	@l2n	@l2nd
exudes	exuded	Igzjudz	IgzjudId
rationalize	rationalized	r{SH@l2z	r{SH@l2zd
reign	reigned	r1n	r1nd
supervises	supervised	sup@v2zIz	sup@v2zd
signals	signalled	sIgnPz	sIgnPd
sweeten	sweetened	switH	switHd
circles	circled	s3kPz	s3kPd
scrimshanks	scrimshanked	skrImS{Nks	skrImS{Nkt
administer	administered	@dmInIst@R	@dmInIst@d
forgives	forgave	f@gIvz	f@g1v
crave	craved	kr1v	kr1vd
drop	dropped	drQp	drQpt
continue	continued	k@ntInju	k@ntInjud
mingle	mingled	mINgP	mINgPd
upsets	upset	VpsEts	VpsEt
lace	laced	l1s	l1st
notifies	notified	n5tIf2z	n5tIf2d
tokens	tokened	t5k@nz	t5k@nd
levels	levelled	lEvPz	lEvPd
rucks	rucked	rVks	rVkt
phones	phoned	f5nz	f5nd
flounces	flounced	fl6nsIz	fl6nst
indulges	indulged	IndVl_Iz	IndVl_d
nominate	nominated	nQmIn1t	nQmIn1tId
twits	twitted	twIts	twItId
summer	summered	sVm@R	sVm@d
fricassee	fricasseed	"frIk@si	"frIk@sid
perceive	perceived	p@siv	p@sivd
intoxicate	intoxicated	IntQksIk1t	IntQksIk1tId
extradite	extradited	Ekstr@d2t	Ekstr@d2tId
electrifies	electrified	IlEktrIf2z	IlEktrIf2d
deliquesce	deliquesced	"dElIkwEs	"dElIkwEst
perforates	perforated	p3f@r1ts	p3f@r1tId
dignifies	dignified	dIgnIf2z	dIgnIf2d
sacrifice	sacrificed	s{krIf2s	s{krIf2st
loft	lofted	lQft	lQftId
palatalizes	palatalized	p{l@t@l2zIz	p{l@t@l2zd
surprises	surprised	s@pr2zIz	s@pr2zd
reeducates	reeducated	"riEdjUk1ts	"riEdjUk1tId
mature	matured	m@tj9R	m@tj9d
throw	threw	Tr5	Tru
circumcises	circumcised	s3k@ms2zIz	s3k@ms2zd
closes	closed	kl5zIz	kl5zd
stop	stopped	stQp	stQpt
boom	boomed	bum	bumd
lurk	lurked	l3k	l3kt
gargles	gargled	g#gPz	g#gPd
distrusts	distrusted	dIstrVsts	dIstrVstId
weight	weighted	w1t	w1tId
blow	blew	bl5	blu
builds	built	bIldz	bIlt
threaten	threatened	TrEtH	TrEtHd
kidnap	kidnapped	kIdn{p	kIdn{pt
type	typed	t2p	t2pt
summarize	summarized	sVm@r2z	sVm@r2zd
avows	avowed	@v6z	@v6d
multiplies	multiplied	mVltIpl2z	mVltIpl2d
tamps	tamped	t{mps	t{mpt
padlocks	padlocked	p{dlQks	p{dlQkt
abide	abode	@b2d	@b5d
intern	interned	Int3n	Int3nd
bicycle	bicycled	b2sIkP	b2sIkPd
fox	foxed	fQks	fQkst
pound	pounded	p6nd	p6ndId
copies	copied	kQpIz	kQpId
ask	asked	#sk	#skt
analyses	analysed	{n@l2zIz	{n@l2zd
anoint	anointed	@n4nt	@n4ntId
bound	bounded	b6nd	b6ndId
snows	snowed	sn5z	sn5d
befuddles	befuddled	bIfVdPz	bIfVdPd
pads	padded	p{dz	p{dId
levitate	levitated	lEvIt1t	lEvIt1tId
plates	plated	pl1ts	pl1tId
point	pointed	p4nt	p4ntId
nominates	nominated	nQmIn1ts	nQmIn1tId
deprave	depraved	dIpr1v	dIpr1vd
slosh	sloshed	slQS	slQSt
rive	rove	r2v	r5v
shins	shinned	SInz	SInd
experience	experienced	Iksp7r7ns	Iksp7r7nst
leer	leered	l7R	l7d
owes	owed	5z	5d
watch	watched	wQJ	wQJt
tighten	tightened	t2tH	t2tHd
embody	embodied	ImbQdI	ImbQdId
seasons	seasoned	sizHz	sizHd
erect	erected	IrEkt	IrEktId
muse	mused	mjuz	mjuzd
complements	complemented	kQmplImEnts	kQmplImEntId
staggers	staggered	st{g@z	st{g@d
defalcates	defalcated	dif{lk1ts	dif{lk1tId
cores	cored	k$z	k$d
contends	contended	k@ntEndz	k@ntEndId
sulks	sulked	sVlks	sVlkt
disappoints	disappointed	"dIs@p4nts	"dIs@p4ntId
omit	omitted	@mIt	@mItId
dogs	dogged	dQgz	dQgd
reprieves	reprieved	rIprivz	rIprivd
supports	supported	s@p$ts	s@p$tId
peel	peeled	pil	pild
upholds	upheld	Vph5ldz	VphEld
bang	banged	b{N	b{Nd
chink	chinked	JINk	JINkt
belittles	belittled	bIlItPz	bIlItPd
shear	shore	S7R	S$R
discards	discarded	dIsk#dz	dIsk#dId
blazon	blazoned	bl1zH	bl1zHd
features	featured	fiJ@z	fiJ@d
soldier	soldiered	s5l_@R	s5l_@d
close	closed	kl5z	kl5zd
pose	posed	p5z	p5zd
spots	spotted	spQts	spQtId
correlate	correlated	kQr@l1t	kQr@l1tId
endures	endured	Indj9z	Indj9d
shears	shore	S7z	S$R
visits	visited	vIzIts	vIzItId
explore	explored	Ikspl$R	Ikspl$d
regain	regained	rIg1n	rIg1nd
ring	rung	rIN	rVN
exaggerate	exaggerated	Igz{_@r1t	Igz{_@r1tId
treat	treated	trit	tritId
fork	forked	f$k	f$kt
saw	sawed	s$	s$d
concrete	concreted	kQNkrit	kQNkritId
invites	invited	Inv2ts	Inv2tId
identify	identified	2dEntIf2	2dEntIf2d
connote	connoted	k@n5t	k@n5tId
arouse	aroused	@r6z	@r6zd
document	documented	dQkjUmEnt	dQkjUmEntId
politicize	politicized	p@lItIs2z	p@lItIs2zd
reconciles	reconciled	rEk@ns2lz	rEk@ns2ld
flourishes	flourished	flVrISIz	flVrISt
guzzle	guzzled	gVzP	gVzPd
thrill	thrilled	TrIl	TrIld
detaches	detached	dIt{JIz	dIt{Jt
repeat	repeated	rIpit	rIpitId
fracture	fractured	fr{kJ@R	fr{kJ@d
squints	squinted	skwInts	skwIntId
spouts	spouted	sp6ts	sp6tId
personalizes	personalized	p3sH@l2zIz	p3sH@l2zd
containerize	containerized	k@nt1n@r2z	k@nt1n@r2zd
chlorinate	chlorinated	kl$rIn1t	kl$rIn1tId
discredit	discredited	dIskrEdIt	dIskrEdItId
focusses	focussed	f5k@sIz	f5k@st
mates	mated	m1ts	m1tId
explains	explained	Ikspl1nz	Ikspl1nd
defies	defied	dIf2z	dIf2d
repossesses	repossessed	"rip@zEsIz	"rip@zEst
crate	crated	kr1t	kr1tId
clinches	clinched	klInJIz	klInJt
soundproofs	soundproofed	s6ndprufs	s6ndpruft
oversell	oversold	"5v@sEl	"5v@s5ld
plenishes	plenished	plEnISIz	plEnISt
token	tokened	t5k@n	t5k@nd
emancipates	emancipated	Im{nsIp1ts	Im{nsIp1tId
labels	labelled	l1bPz	l1bPd
annoy	annoyed	@n4	@n4d
forges	forged	f$_Iz	f$_d
budge	budged	bV_	bV_d
drips	dripped	drIps	drIpt
seals	sealed	silz	sild
methylates	methylated	mET@l1ts	mET@l1tId
phase	phased	f1z	f1zd
mint	minted	mInt	mIntId
tranquillizes	tranquillized	tr{NkwIl2zIz	tr{NkwIl2zd
savage	savaged	s{vI_	s{vI_d
cheer	cheered	J7R	J7d
woolgathers	woolgathered	wUl"g{D@z	wUl"g{D@d
splotch	splotched	splQJ	splQJt
summarizes	summarized	sVm@r2zIz	sVm@r2zd
understand	understood	"Vnd@st{nd	"Vnd@stud
vouchsafe	vouchsafed	v6Js1f	v6Js1ft
lames	lamed	l1mz	l1md
wrong	wronged	rQN	rQNd
black	blacked	bl{k	bl{kt
estrange	estranged	Istr1n_	Istr1n_d
pinions	pinioned	pInj@nz	pInj@nd
displease	displeased	dIspliz	dIsplizd
dismember	dismembered	dIsmEmb@R	dIsmEmb@d
hood	hooded	hUd	hUdId
overcapitalizes	overcapitalized	"5v@k{pIt@l2zIz	"5v@k{pIt@l2zd
resinate	resinated	rEsI"n1t	rEsI"n1tId
includes	included	Inkludz	InkludId
anathematize	anathematized	@n{T@m@t2z	@n{T@m@t2zd
strikes	struck	str2ks	strVk
fades	faded	f1dz	f1dId
rebuild	rebuilt	"ribIld	"ribIlt
assembles	assembled	@sEmbPz	@sEmbPd
book	booked	bUk	bUkt
rings	rung	rINz	rVN
mutter	muttered	mVt@R	mVt@d
barrages	barraged	b{r#ZIz	b{r#Zd
busk	busked	bVsk	bVskt
patronizes	patronized	p{tr@n2zIz	p{tr@n2zd
invents	invented	InvEnts	InvEntId
plummets	plummetted	plVmIts	plVmItId
lives	lived	lIvz	lIvd
conserve	conserved	k@ns3v	k@ns3vd
rats	ratted	r{ts	r{tId
plan	planned	pl{n	pl{nd
consider	considered	k@nsId@R	k@nsId@d
stipple	stippled	stIpP	stIpPd
leads	led	lidz	lEd
relates	related	rIl1ts	rIl1tId
requires	required	rIkw2@z	rIkw2@d
disendow	disendowed	"dIsInd6	"dIsInd6d
harvests	harvested	h#vIsts	h#vIstId
rake	raked	r1k	r1kt
whelps	whelped	wElps	wElpt
sulk	sulked	sVlk	sVlkt
plonks	plonked	plQNks	plQNkt
subsumes	subsumed	s@bsjumz	s@bsjumd
ripens	ripened	r2p@nz	r2p@nd
machine	machined	m@Sin	m@Sind
prevents	prevented	prIvEnts	prIvEntId
mediates	mediated	midI1ts	midI1tId
lashes	lashed	l{SIz	l{St
wizen	wizened	wIzH	wIzHd
knocks	knocked	nQks	nQkt
harm	harmed	h#m	h#md
bring	brought	brIN	br$t
happen	happened	h{p@n	h{p@nd
mesh	meshed	mES	mESt
wedges	wedged	wE_Iz	wE_d
damages	damaged	d{mI_Iz	d{mI_d
explores	explored	Ikspl$z	Ikspl$d
drowns	drowned	dr6nz	dr6nd
extinguish	extinguished	IkstINgwIS	IkstINgwISt
burgeons	burgeoned	b3_@nz	b3_@nd
binds	bound	b2ndz	b6nd
slacken	slackened	sl{k@n	sl{k@nd
announces	announced	@n6nsIz	@n6nst
trains	trained	tr1nz	tr1nd
baths	bathed	b#Ts	b1Dd
co-ordinates	co-ordinated	k5$dIn1ts	k5$dIn1tId
pressurize	pressurized	prES@r2z	prES@r2zd
give	gave	gIv	g1v
evicts	evicted	IvIkts	IvIktId
manifest	manifested	m{nIfEst	m{nIfEstId
finalizes	finalized	f2n@l2zIz	f2n@l2zd
transcends	transcended	tr{nsEndz	tr{nsEndId
unsettles	unsettled	"VnsEtPz	"VnsEtPd
retrieve	retrieved	rItriv	rItrivd
lick	licked	lIk	lIkt
steals	stole	stilz	st5l
realize	realized	r7l2z	r7l2zd
execute	executed	EksIkjut	EksIkjutId
sharpens	sharpened	S#p@nz	S#p@nd
pounce	pounced	p6ns	p6nst
blab	blabbed	bl{b	bl{bd
acts	acted	{kts	{ktId
hinder	hindered	hInd@R	hInd@d
fume	fumed	fjum	fjumd
keeps	kept	kips	kEpt
subtracts	subtracted	s@btr{kts	s@btr{ktId
cosh	coshed	kQS	kQSt
lassoes	lassoed	l{suz	l{sud
jolt	jolted	_5lt	_5ltId
chortles	chortled	J$tPz	J$tPd
anathematizes	anathematized	@n{T@m@t2zIz	@n{T@m@t2zd
wonders	wondered	wVnd@z	wVnd@d
consummates	consummated	kQns@m1ts	kQns@m1tId
comprehend	comprehended	"kQmprIhEnd	"kQmprIhEndId
fancy	fancied	f{nsI	f{nsId
augur	augured	$g@R	$g@d
embarks	embarked	Imb#ks	Imb#kt
typifies	typified	tIpIf2z	tIpIf2d
putts	putted	pVts	pVtId
camps	camped	k{mps	k{mpt
recall	recalled	rIk$l	rIk$ld
motorize	motorized	m5t@r2z	m5t@r2zd
satisfies	satisfied	s{tIsf2z	s{tIsf2d
breathalyses	breathalysed	brET@l2zIz	brET@l2zd
beseems	beseemed	bIsimz	bIsimd
commingles	commingled	kQmINgPz	kQmINgPd
paddle	paddled	p{dP	p{dPd
attenuates	attenuated	@tEnjU1ts	@tEnjU1tId
hulls	hulled	hVlz	hVld
undo	undid	"Vndu	"VndId
organizes	organized	$g@n2zIz	$g@n2zd
pressgangs	pressganged	prEsg{Nz	prEsg{Nd
disagree	disagreed	"dIs@gri	"dIs@grid
bulldoze	bulldozed	bUld5z	bUld5zd
curbs	curbed	k3bz	k3bd
winches	winched	wInJIz	wInJt
marinades	marinaded	"m{rIn1dz	"m{rIn1dId
jeopardize	jeopardized	_Ep@d2z	_Ep@d2zd
swots	swotted	swQts	swQtId
slop	slopped	slQp	slQpt
sham	shammed	S{m	S{md
objects	objected	@b_Ekts	@b_EktId
proportion	proportioned	pr@p$SH	pr@p$SHd
surrender	surrendered	s@rEnd@R	s@rEnd@d
ticks	ticked	tIks	tIkt
proceed	proceeded	pr@sid	pr@sidId
deplane	deplaned	"dipl1n	"dipl1nd
file	filed	f2l	f2ld
skulks	skulked	skVlks	skVlkt
gawps	gawped	g$ps	g$pt
fords	forded	f$dz	f$dId
scrags	scragged	skr{gz	skr{gd
projects	projected	pr@_Ekts	pr@_EktId
suck	sucked	sVk	sVkt
jolts	jolted	_5lts	_5ltId
chip	chipped	JIp	JIpt
tie-dye	tie-dyed	t2d2	t2d2d
burns	burnt	b3nz	b3nt
sweetens	sweetened	switHz	switHd
disinclines	disinclined	"dIsInkl2nz	"dIsInkl2nd
forks	forked	f$ks	f$kt
marches	marched	m#JIz	m#Jt
stiffens	stiffened	stIfHz	stIfHd
prefer	preferred	prIf3R	prIf3d
transports	transported	tr{nsp$ts	tr{nsp$tId
starches	starched	st#JIz	st#Jt
bite	bit	b2t	bIt
distort	distorted	dIst$t	dIst$tId
counteract	counteracted	"k6nt@r{kt	"k6nt@r{ktId
go	went	g5	wEnt
disregards	disregarded	"dIsrIg#dz	"dIsrIg#dId
burke	burked	b3k	b3kt
enforces	enforced	Inf$sIz	Inf$st
drops	dropped	drQps	drQpt
gazump	gazumped	g@zVmp	g@zVmpt
fade	faded	f1d	f1dId
curtains	curtained	k3tHz	k3tHd
remind	reminded	rIm2nd	rIm2ndId
footnotes	footnoted	fUtn5ts	fUtn5tId
obscure	obscured	@bskj9R	@bskj9d
expostulates	expostulated	IkspQsJUl1ts	IkspQsJUl1tId
eavesdrop	eavesdropped	ivzdrQp	ivzdrQpt
vote	voted	v5t	v5tId
sates	sated	s1ts	s1tId
okays	okayed	"5k1z	"5k1d
clerk	clerked	kl#k	kl#kt
outclasses	outclassed	"6tkl#sIz	"6tkl#st
slugs	slugged	slVgz	slVgd
prevail	prevailed	prIv1l	prIv1ld
disprove	disproved	"dIspruv	"dIspruvd
braves	braved	br1vz	br1vd
mourn	mourned	m$n	m$nd
ruffs	ruffed	rVfs	rVft
excuses	excused	IkskjuzIz	Ikskjuzd
dissatisfies	dissatisfied	"dIss{tIsf2z	"dIss{tIsf2d
frolic	frolicked	frQlIk	frQlIkt
sounds	sounded	s6ndz	s6ndId
instruct	instructed	InstrVkt	InstrVktId
weds	wed	wEdz	wEd
jaunts	jaunted	_$nts	_$ntId
invests	invested	InvEsts	InvEstId
cost	cost	kQst	kQst
enamours	enamoured	In{m@z	In{m@d
supplies	supplied	s@pl2z	s@pl2d
shambles	shambled	S{mbPz	S{mbPd
condemn	condemned	k@ndEm	k@ndEmd
delights	delighted	dIl2ts	dIl2tId
clogs	clogged	klQgz	klQgd
replenishes	replenished	rIplEnISIz	rIplEnISt
completes	completed	k@mplits	k@mplitId
reminds	reminded	rIm2ndz	rIm2ndId
prinks	prinked	prINks	prINkt
cleanse	cleansed	klEnz	klEnzd
collar	collared	kQl@R	kQl@d
barrage	barraged	b{r#Z	b{r#Zd
lure	lured	l9R	l9d
ease	eased	iz	izd
simmer	simmered	sIm@R	sIm@d
beseeches	besought	bIsiJIz	bIs$t
introduce	introduced	"Intr@djus	"Intr@djust
strangles	strangled	str{NgPz	str{NgPd
domineers	domineered	"dQmIn7z	"dQmIn7d
offer	offered	Qf@R	Qf@d
fail	failed	f1l	f1ld
comprise	comprised	k@mpr2z	k@mpr2zd
rafts	rafted	r#fts	r#ftId
uncork	uncorked	"Vnk$k	"Vnk$kt
sites	sited	s2ts	s2tId
vocalizes	vocalized	v5k@l2zIz	v5k@l2zd
chortle	chortled	J$tP	J$tPd
glimmers	glimmered	glIm@z	glIm@d
narrow	narrowed	n{r5	n{r5d
recharge	recharged	"riJ#_	"riJ#_d
window-shops	window-shopped	wInd5SQps	wInd5SQpt
implicates	implicated	ImplIk1ts	ImplIk1tId
pinpoints	pinpointed	pInp4nts	pInp4ntId
employs	employed	Impl4z	Impl4d
snowball	snowballed	sn5b$l	sn5b$ld
retouch	retouched	"ritVJ	"ritVJt
protuberates	protuberated	pr@tjub@"r1ts	pr@tjub@"r1tId
needs	needed	nidz	nidId
prohibits	prohibited	pr@hIbIts	pr@hIbItId
try	tried	tr2	tr2d
slews	slewed	sluz	slud
nixes	nixed	nIksIz	nIkst
pillow	pillowed	pIl5	pIl5d
yawn	yawned	j$n	j$nd
mars	marred	m#z	m#d
countervail	countervailed	k6nt@v1l	k6nt@v1ld
fuss	fussed	fVs	fVst
drudges	drudged	drV_Iz	drV_d
lassoes	lassoed	l{suz	l{sud
breakfasts	breakfasted	brEkf@sts	brEkf@stId
thrums	thrummed	TrVmz	TrVmd
stint	stinted	stInt	stIntId
bawls	bawled	b$lz	b$ld
expunge	expunged	IkspVn_	IkspVn_d
surmount	surmounted	s3m6nt	s3m6ntId
overplay	overplayed	"5v@pl1	"5v@pl1d
persevere	persevered	"p3sIv7R	"p3sIv7d
specify	specified	spEsIf2	spEsIf2d
preheat	preheated	"prihit	"prihitId
convince	convinced	k@nvIns	k@nvInst
demonstrate	demonstrated	dEm@nstr1t	dEm@nstr1tId
stipulate	stipulated	stIpjUl1t	stIpjUl1tId
guards	guarded	g#dz	g#dId
paint	painted	p1nt	p1ntId
imprecates	imprecated	ImprIk1ts	ImprIk1tId
consign	consigned	k@ns2n	k@ns2nd
simmers	simmered	sIm@z	sIm@d
deduces	deduced	dIdjusIz	dIdjust
ready	readied	rEdI	rEdId
rushes	rushed	rVSIz	rVSt
immunizes	immunized	Imjun2zIz	Imjun2zd
nooses	noosed	nusIz	nust
seduces	seduced	sIdjusIz	sIdjust
scrabble	scrabbled	skr{bP	skr{bPd
pole-vault	pole-vaulted	p5lv$lt	p5lv$ltId
outclass	outclassed	"6tkl#s	"6tkl#st
prizes	prized	pr2zIz	pr2zd
war	warred	w$R	w$d
contacts	contacted	kQnt{kts	kQnt{ktId
overcapitalize	overcapitalized	"5v@k{pIt@l2z	"5v@k{pIt@l2zd
tear	tore	t8R	t$R
prop	propped	prQp	prQpt
credit	credited	krEdIt	krEdItId
utilize	utilized	jut@l2z	jut@l2zd
quips	quipped	kwIps	kwIpt
accumulate	accumulated	@kjumjUl1t	@kjumjUl1tId
compensates	compensated	kQmpEns1ts	kQmpEns1tId
disjoint	disjointed	dIs_4nt	dIs_4ntId
hamstring	hamstrung	h{mstrIN	h{mstrVN
qualifies	qualified	kwQlIf2z	kwQlIf2d
exerts	exerted	Igz3ts	Igz3tId
muses	mused	mjuzIz	mjuzd
immerse	immersed	Im3s	Im3st
spills	spilt	spIlz	spIlt
uproots	uprooted	Vpruts	VprutId
kids	kidded	kIdz	kIdId
slops	slopped	slQps	slQpt
shanghais	shanghaied	"S{Nh2z	"S{Nh2d
dismisses	dismissed	dIsmIsIz	dIsmIst
smile	smiled	sm2l	sm2ld
misdemean	misdemeaned	"mIsdImin	"mIsdImind
tracks	tracked	tr{ks	tr{kt
influences	influenced	Infl9nsIz	Infl9nst
betters	bettered	bEt@z	bEt@d
disincline	disinclined	"dIsInkl2n	"dIsInkl2nd
considers	considered	k@nsId@z	k@nsId@d
pressgang	pressganged	prEsg{N	prEsg{Nd
proscribe	proscribed	pr5skr2b	pr5skr2bd
bemoans	bemoaned	bIm5nz	bIm5nd
keep	kept	kip	kEpt
revamp	revamped	riv{mp	riv{mpt
shin	shinned	SIn	SInd
surfaces	surfaced	s3fIsIz	s3fIst
revamp	revamped	riv{mp	riv{mpt
muckrake	muckraked	mVkr1k	mVkr1kt
manhandle	manhandled	m{n"h{ndP	m{n"h{ndPd
horrify	horrified	hQrIf2	hQrIf2d
buy	bought	b2	b$t
memorize	memorized	mEm@r2z	mEm@r2zd
possess	possessed	p@zEs	p@zEst
bootlegs	bootlegged	but"lEgz	but"lEgd
snuffs	snuffed	snVfs	snVft
twig	twigged	twIg	twIgd
slouch	slouched	sl6J	sl6Jt
deplane	deplaned	"dipl1n	"dipl1nd
doubt	doubted	d6t	d6tId
ices	iced	2sIz	2st
ascertains	ascertained	"{s@t1nz	"{s@t1nd
footnote	footnoted	fUtn5t	fUtn5tId
bill	billed	bIl	bIld
power	powered	p6@R	p6@d
worries	worried	wVrIz	wVrId
uproot	uprooted	Vprut	VprutId
lash	lashed	l{S	l{St
lurks	lurked	l3ks	l3kt
desalinizes	desalinized	"dis{lIn2zIz	"dis{lIn2zd
executes	executed	EksIkjuts	EksIkjutId
rinses	rinsed	rInsIz	rInst
shares	shared	S8z	S8d
attain	attained	@t1n	@t1nd
flashes	flashed	fl{SIz	fl{St
weeps	wept	wips	wEpt
tootles	tootled	tutPz	tutPd
depicts	depicted	dIpIkts	dIpIktId
simplifies	simplified	sImplIf2z	sImplIf2d
sings	sang	sINz	s{N
exaggerates	exaggerated	Igz{_@r1ts	Igz{_@r1tId
crawl	crawled	kr$l	kr$ld
analyse	analysed	{n@l2z	{n@l2zd
issues	issued	ISuz	ISud
blink	blinked	blINk	blINkt
blacken	blackened	bl{k@n	bl{k@nd
subdivides	subdivided	"sVbdIv2dz	"sVbdIv2dId
spend	spent	spEnd	spEnt
hearken	hearkened	h#k@n	h#k@nd
spanks	spanked	sp{Nks	sp{Nkt
trap	trapped	tr{p	tr{pt
bludgeons	bludgeoned	blV_@nz	blV_@nd
enables	enabled	In1bPz	In1bPd
quacks	quacked	kw{ks	kw{kt
style	styled	st2l	st2ld
chlorinates	chlorinated	kl$rIn1ts	kl$rIn1tId
trepan	trepanned	trIp{n	trIp{nd
selects	selected	sIlEkts	sIlEktId
work	wrought	w3k	r$t
quarrel	quarrelled	kwQr@l	kwQr@ld
retard	retarded	rIt#d	rIt#dId
persecute	persecuted	p3sIkjut	p3sIkjutId
disperse	dispersed	dIsp3s	dIsp3st
gains	gained	g1nz	g1nd
cheeks	cheeked	Jiks	Jikt
mires	mired	m2@z	m2@d
chains	chained	J1nz	J1nd
repossess	repossessed	"rip@zEs	"rip@zEst
stabs	stabbed	st{bz	st{bd
clash	clashed	kl{S	kl{St
recovers	recovered	rIkVv@z	rIkVv@d
fight	fought	f2t	f$t
poke	poked	p5k	p5kt
crackles	crackled	kr{kPz	kr{kPd
core	cored	k$R	k$d
preconceives	preconceived	"prik@nsivz	"prik@nsivd
contort	contorted	k@nt$t	k@nt$tId
cleanse	cleansed	klEnz	klEnzd
changes	changed	J1n_Iz	J1n_d
supplements	supplemented	sVplImEnts	sVplImEntId
interpret	interpreted	Int3prIt	Int3prItId
enplane	enplaned	Inpl1n	Inpl1nd
decapitates	decapitated	dIk{pIt1ts	dIk{pIt1tId
tip	tipped	tIp	tIpt
shag	shagged	S{g	S{gd
loathes	loathed	l5Dz	l5Dd
notice	noticed	n5tIs	n5tIst
manoeuvres	manoeuvred	m@nuv@z	m@nuv@d
protuberate	protuberated	pr@tjub@"r1t	pr@tjub@"r1tId
localize	localized	l5k@l2z	l5k@l2zd
questions	questioned	kwEsJ@nz	kwEsJ@nd
metricate	metricated	mEtrI"k1t	mEtrI"k1tId
telescope	telescoped	tElIsk5p	tElIsk5pt
lilts	lilted	lIlts	lIltId
reprobate	reprobated	rEpr5b1t	rEpr5b1tId
figure	figured	fIg@R	fIg@d
envisages	envisaged	InvIzI_Iz	InvIzI_d
inquire	inquired	Inkw2@R	Inkw2@d
pins	pinned	pInz	pInd
humours	humoured	hjum@z	hjum@d
indicate	indicated	IndIk1t	IndIk1tId
mimeograph	mimeographed	mIm7gr#f	mIm7gr#ft
burden	burdened	b3dH	b3dHd
hurdles	hurdled	h3dPz	h3dPd
pat	patted	p{t	p{tId
transmits	transmitted	tr{nzmIts	tr{nzmItId
jollies	jollied	_QlIz	_QlId
despise	despised	dIsp2z	dIsp2zd
apply	applied	@pl2	@pl2d
deliquesce	deliquesced	"dElIkwEs	"dElIkwEst
vomits	vomited	vQmIts	vQmItId
disrupt	disrupted	dIsrVpt	dIsrVptId
hydrates	hydrated	h2dr1ts	h2dr1tId
entails	entailed	Int1lz	Int1ld
vamps	vamped	v{mps	v{mpt
kotow	kotowed	"k5t6	"k5t6d
powder	powdered	p6d@R	p6d@d
roosts	roosted	rusts	rustId
assumes	assumed	@sjumz	@sjumd
wrecks	wrecked	rEks	rEkt
divert	diverted	d2v3t	d2v3tId
waft	wafted	w#ft	w#ftId
inoculate	inoculated	InQkjUl1t	InQkjUl1tId
mentions	mentioned	mEnSHz	mEnSHd
jugs	jugged	_Vgz	_Vgd
rekindles	rekindled	"rikIndPz	"rikIndPd
exterminate	exterminated	Ikst3mIn1t	Ikst3mIn1tId
inlay	inlaid	Inl1	Inl1d
burdens	burdened	b3dHz	b3dHd
incur	incurred	Ink3R	Ink3d
pretend	pretended	prItEnd	prItEndId
tell	told	tEl	t5ld
crimp	crimped	krImp	krImpt
blinks	blinked	blINks	blINkt
steal	stole	stil	st5l
begins	began	bIgInz	bIg{n
uses	used	juzIz	juzd
scans	scanned	sk{nz	sk{nd
putt	putted	pVt	pVtId
tittle-tattle	tittle-tattled	tItP"t{tP	tItP"t{tPd
whisks	whisked	wIsks	wIskt
thrive	throve	Tr2v	Tr5v
channel	channelled	J{nP	J{nPd
cash	cashed	k{S	k{St
kidnaps	kidnapped	kIdn{ps	kIdn{pt
wizens	wizened	wIzHz	wIzHd
pulls	pulled	pUlz	pUld
cuts	cut	kVts	kVt
reviews	reviewed	rIvjuz	rIvjud
operates	operated	Qp@r1ts	Qp@r1tId
teases	teased	tizIz	tizd
irons	ironed	2@nz	2@nd
extrude	extruded	Ikstrud	IkstrudId
dock	docked	dQk	dQkt
increases	increased	InkrisIz	Inkrist
disapprove	disapproved	"dIs@pruv	"dIs@pruvd
immortalize	immortalized	Im$t@l2z	Im$t@l2zd
conceals	concealed	k@nsilz	k@nsild
sleets	sleeted	slits	slitId
bangs	banged	b{Nz	b{Nd
wedge	wedged	wE_	wE_d
prink	prinked	prINk	prINkt
boos	booed	buz	bud
peculate	peculated	pEkjUl1t	pEkjUl1tId
deals	dealt	dilz	dElt
reproof	reproofed	"ripruf	"ripruft
hiss	hissed	hIs	hIst
stifles	stifled	st2fPz	st2fPd
relieve	relieved	rIliv	rIlivd
prosecutes	prosecuted	prQsIkjuts	prQsIkjutId
convulse	convulsed	k@nvVls	k@nvVlst
dies	died	d2z	d2d
penetrates	penetrated	pEnItr1ts	pEnItr1tId
deliver	delivered	dIlIv@R	dIlIv@d
ricks	ricked	rIks	rIkt
dam	dammed	d{m	d{md
cusses	cussed	kVsIz	kVst
insists	insisted	InsIsts	InsIstId
lave	laved	l1v	l1vd
isolates	isolated	2s@l1ts	2s@l1tId
shrug	shrugged	SrVg	SrVgd
reminisces	reminisced	"rEmInIsIz	"rEmInIst
overtakes	overtook	"5v@t1ks	"5v@tUk
functions	functioned	fVNkSHz	fVNkSHd
part	parted	p#t	p#tId
clang	clanged	kl{N	kl{Nd
distrusts	distrusted	dIstrVsts	dIstrVstId
docks	docked	dQks	dQkt
props	propped	prQps	prQpt
water	watered	w$t@R	w$t@d
haunt	haunted	h$nt	h$ntId
gate	gated	g1t	g1tId
humour	humoured	hjum@R	hjum@d
testify	testified	tEstIf2	tEstIf2d
undercuts	undercut	"Vnd@kVts	"Vnd@kVt
mutters	muttered	mVt@z	mVt@d
hog	hogged	hQg	hQgd
chases	chased	J1sIz	J1st
skates	skated	sk1ts	sk1tId
axe	axed	{ks	{kst
forages	foraged	fQrI_Iz	fQrI_d
slims	slimmed	slImz	slImd
coincides	coincided	"k5Ins2dz	"k5Ins2dId
whip	whipped	wIp	wIpt
reveres	revered	rIv7z	rIv7d
remainder	remaindered	rIm1nd@R	rIm1nd@d
engross	engrossed	Ingr5s	Ingr5st
harvest	harvested	h#vIst	h#vIstId
deciphers	deciphered	dIs2f@z	dIs2f@d
forgoes	forwent	f$g5z	f$wEnt
enshrines	enshrined	InSr2nz	InSr2nd
ridicule	ridiculed	rIdIkjul	rIdIkjuld
imprecate	imprecated	ImprIk1t	ImprIk1tId
palatalize	palatalized	p{l@t@l2z	p{l@t@l2zd
encourages	encouraged	InkVrI_Iz	InkVrI_d
disciplines	disciplined	dIsIplInz	dIsIplInd
disfigure	disfigured	dIsfIg@R	dIsfIg@d
inconveniences	inconvenienced	"Ink@nvinj@nsIz	"Ink@nvinj@nst
forfeit	forfeited	f$fIt	f$fItId
replies	replied	rIpl2z	rIpl2d
scout	scouted	sk6t	sk6tId
disable	disabled	dIs1bP	dIs1bPd
depraves	depraved	dIpr1vz	dIpr1vd
readies	readied	rEdIz	rEdId
bother	bothered	bQD@R	bQD@d
works	wrought	w3ks	r$t
dines	dined	d2nz	d2nd
trots	trotted	trQts	trQtId
recruits	recruited	rIkruts	rIkrutId
subpoenas	subpoenaed	s@bpin@z	s@bpin@d
founders	foundered	f6nd@z	f6nd@d
seem	seemed	sim	simd
estranges	estranged	Istr1n_Iz	Istr1n_d
rescues	rescued	rEskjuz	rEskjud
nix	nixed	nIks	nIkst
revel	revelled	rEvP	rEvPd
remains	remained	rIm1nz	rIm1nd
pace	paced	p1s	p1st
overlooks	overlooked	"5v@lUks	"5v@lUkt
treads	trod	trEdz	trQd
waves	waved	w1vz	w1vd
deliquesces	deliquesced	"dElIkwEsIz	"dElIkwEst
participates	participated	p#tIsIp1ts	p#tIsIp1tId
nibble	nibbled	nIbP	nIbPd
womanize	womanized	wUm@n2z	wUm@n2zd
unscrews	unscrewed	"Vnskruz	"Vnskrud
hunt	hunted	hVnt	hVntId
dine	dined	d2n	d2nd
muffle	muffled	mVfP	mVfPd
ravage	ravaged	r{vI_	r{vI_d
stocks	stocked	stQks	stQkt
results	resulted	rIzVlts	rIzVltId
shove	shoved	SVv	SVvd
shrinks	shrunk	SrINks	SrVNk
evaluates	evaluated	Iv{ljU1ts	Iv{ljU1tId
implies	implied	Impl2z	Impl2d
mends	mended	mEndz	mEndId
cobble	cobbled	kQbP	kQbPd
stone	stoned	st5n	st5nd
squelch	squelched	skwElJ	skwElJt
conspire	conspired	k@nsp2@R	k@nsp2@d
regards	regarded	rIg#dz	rIg#dId
gauges	gauged	g1_Iz	g1_d
shrimp	shrimped	SrImp	SrImpt
pressurizes	pressurized	prES@r2zIz	prES@r2zd
foretell	foretold	f$tEl	f$t5ld
bead	beaded	bid	bidId
rehears	reheard	"rih7z	"rih3d
reserve	reserved	rIz3v	rIz3vd
posts	posted	p5sts	p5stId
brightens	brightened	br2tHz	br2tHd
centre	centred	sEnt@R	sEnt@d
prohibit	prohibited	pr@hIbIt	pr@hIbItId
jolt	jolted	_5lt	_5ltId
vent	vented	vEnt	vEntId
implements	implemented	ImplImEnts	ImplImEntId
ricochets	ricochetted	rIk@S1z	rIk@S1d
striates	striated	str21ts	str21tId
succumb	succumbed	s@kVm	s@kVmd
misstates	misstated	"mIsst1ts	"mIsst1tId
trumps	trumped	trVmps	trVmpt
excites	excited	Iks2ts	Iks2tId
repatriates	repatriated	rip{trI1ts	rip{trI1tId
bunk	bunked	bVNk	bVNkt
retards	retarded	rIt#dz	rIt#dId
lift	lifted	lIft	lIftId
moralizes	moralized	mQr@l2zIz	mQr@l2zd
returns	returned	rIt3nz	rIt3nd
eliminate	eliminated	IlImIn1t	IlImIn1tId
stuffs	stuffed	stVfs	stVft
flavour	flavoured	fl1v@R	fl1v@d
flows	flowed	fl5z	fl5d
dispirits	dispirited	dIspIrIts	dIspIrItId
repoint	repointed	"rip4nt	"rip4ntId
fetch	fetched	fEJ	fEJt
seems	seemed	simz	simd
clanks	clanked	kl{Nks	kl{Nkt
clam	clammed	kl{m	kl{md
elucidates	elucidated	IlusId1ts	IlusId1tId
gather	gathered	g{D@R	g{D@d
foreshadows	foreshadowed	f$S{d5z	f$S{d5d
preoccupy	preoccupied	"priQkjUp2	"priQkjUp2d
qualify	qualified	kwQlIf2	kwQlIf2d
conspires	conspired	k@nsp2@z	k@nsp2@d
treats	treated	trits	tritId
rehearses	rehearsed	rIh3sIz	rIh3st
loosen	loosened	lusH	lusHd
powwow	powwowed	p6w6	p6w6d
roams	roamed	r5mz	r5md
reeducate	reeducated	"riEdjUk1t	"riEdjUk1tId
dishorn	dishorned	dIsh$n	dIsh$nd
acclaim	acclaimed	@kl1m	@kl1md
heads	headed	hEdz	hEdId
scream	screamed	skrim	skrimd
taints	tainted	t1nts	t1ntId
beggar	beggared	bEg@R	bEg@d
nibbles	nibbled	nIbPz	nIbPd
chugs	chugged	JVgz	JVgd
censure	censured	sEnS@R	sEnS@d
gulps	gulped	gVlps	gVlpt
depletes	depleted	dIplits	dIplitId
urinate	urinated	j9rIn1t	j9rIn1tId
shags	shagged	S{gz	S{gd
superintends	superintended	"sup@rIntEndz	"sup@rIntEndId
betake	betook	bIt1k	bItUk
hemstitch	hemstitched	hEmstIJ	hEmstIJt
robs	robbed	rQbz	rQbd
belittle	belittled	bIlItP	bIlItPd
shield	shielded	Sild	SildId
resigns	resigned	rIz2nz	rIz2nd
outlines	outlined	6tl2nz	6tl2nd
freeze-dries	freeze-dried	"frizdr2z	"frizdr2d
deplanes	deplaned	"dipl1nz	"dipl1nd
differ	differed	dIf@R	dIf@d
confronts	confronted	k@nfrVnts	k@nfrVntId
modifies	modified	mQdIf2z	mQdIf2d
refracts	refracted	rIfr{kts	rIfr{ktId
fall	fell	f$l	fEl
quack	quacked	kw{k	kw{kt
wields	wielded	wildz	wildId
fucks	fucked	fVks	fVkt
hamper	hampered	h{mp@R	h{mp@d
refaces	refaced	"rif1sIz	"rif1st
fastens	fastened	f#sHz	f#sHd
wing	winged	wIN	wINd
conflicts	conflicted	k@nflIkts	k@nflIktId
seek	sought	sik	s$t
perk	perked	p3k	p3kt
blackens	blackened	bl{k@nz	bl{k@nd
mulch	mulched	mVlJ	mVlJt
trips	tripped	trIps	trIpt
carry	carried	k{rI	k{rId
hand	handed	h{nd	h{ndId
aquaplane	aquaplaned	{kw@pl1n	{kw@pl1nd
score	scored	sk$R	sk$d
manures	manured	m@nj9z	m@nj9d
evicts	evicted	IvIkts	IvIktId
matter	mattered	m{t@R	m{t@d
stump	stumped	stVmp	stVmpt
leap	lope	lip	l5p
resist	resisted	rIzIst	rIzIstId
squelches	squelched	skwElJIz	skwElJt
surface	surfaced	s3fIs	s3fIst
stitch	stitched	stIJ	stIJt
cycles	cycled	s2kPz	s2kPd
pounces	pounced	p6nsIz	p6nst
knit	knit	nIt	nIt
invigilates	invigilated	InvI_Il1ts	InvI_Il1tId
tittle-tattles	tittle-tattled	tItP"t{tPz	tItP"t{tPd
clears	cleared	kl7z	kl7d
repoints	repointed	"rip4nts	"rip4ntId
dissatisfy	dissatisfied	"dIss{tIsf2	"dIss{tIsf2d
relaxes	relaxed	rIl{ksIz	rIl{kst
house	housed	h6z	h6zd
hates	hated	h1ts	h1tId
misnames	misnamed	"mIsn1mz	"mIsn1md
hassles	hassled	h{sPz	h{sPd
accuse	accused	@kjuz	@kjuzd
contorts	contorted	k@nt$ts	k@nt$tId
converse	conversed	k@nv3s	k@nv3st
designs	designed	dIz2nz	dIz2nd
afforest	afforested	{fQrIst	{fQrIstId
primps	primped	prImps	prImpt
gossip	gossipped	gQsIp	gQsIpt
dilute	diluted	d2ljut	d2ljutId
clamps	clamped	kl{mps	kl{mpt
tender	tendered	tEnd@R	tEnd@d
roof	roofed	ruf	ruft
tilts	tilted	tIlts	tIltId
wiggle	wiggled	wIgP	wIgPd
habilitate	habilitated	h@bIlIt1t	h@bIlIt1tId
calm	calmed	k#m	k#md
drip	dripped	drIp	drIpt
two-time	two-timed	tut2m	tut2md
traces	traced	tr1sIz	tr1st
circle	circled	s3kP	s3kPd
plays	played	pl1z	pl1d
wring	wrung	rIN	rVN
scold	scolded	sk5ld	sk5ldId
disfrock	disfrocked	"dIsfrQk	"dIsfrQkt
immures	immured	Imj9z	Imj9d
prolongs	prolonged	pr5lQNz	pr5lQNd
succeed	succeeded	s@ksid	s@ksidId
discusses	discussed	dIskVsIz	dIskVst
dabble	dabbled	d{bP	d{bPd
seines	seined	s1nz	s1nd
perm	permed	p3m	p3md
opens	opened	5p@nz	5p@nd
patrols	patrolled	p@tr5lz	p@tr5ld
crusades	crusaded	krus1dz	krus1dId
berate	berated	bIr1t	bIr1tId
groans	groaned	gr5nz	gr5nd
embrocate	embrocated	Embr5k1t	Embr5k1tId
tabulates	tabulated	t{bjUl1ts	t{bjUl1tId
inter	interred	Int3R	Int3d
fingers	fingered	fINg@z	fINg@d
uncorks	uncorked	"Vnk$ks	"Vnk$kt
accentuate	accentuated	{ksEntjU1t	{ksEntjU1tId
nibble	nibbled	nIbP	nIbPd
conducts	conducted	k@ndVkts	k@ndVktId
reproduces	reproduced	"ripr@djusIz	"ripr@djust
telegraph	telegraphed	tElIgr#f	tElIgr#ft
okay	okayed	"5k1	"5k1d
prevaricates	prevaricated	prIv{rIk1ts	prIv{rIk1tId
roam	roamed	r5m	r5md
expects	expected	IkspEkts	IkspEktId
infatuate	infatuated	Inf{tjU1t	Inf{tjU1tId
hurdle	hurdled	h3dP	h3dPd
reconsider	reconsidered	"rik@nsId@R	"rik@nsId@d
range	ranged	r1n_	r1n_d
design	designed	dIz2n	dIz2nd
clouds	clouded	kl6dz	kl6dId
lays	laid	l1z	l1d
regains	regained	rIg1nz	rIg1nd
brighten	brightened	br2tH	br2tHd
coheres	cohered	k5h7z	k5h7d
attacks	attacked	@t{ks	@t{kt
immortalizes	immortalized	Im$t@l2zIz	Im$t@l2zd
airlift	airlifted	8lIft	8lIftId
pierce	pierced	p7s	p7st
strides	strode	str2dz	str5d
notate	notated	n5t1t	n5t1tId
offends	offended	@fEndz	@fEndId
test	tested	tEst	tEstId
corrects	corrected	k@rEkts	k@rEktId
review	reviewed	rIvju	rIvjud
endorses	endorsed	Ind$sIz	Ind$st
delimitate	delimitated	dIlImIt1t	dIlImIt1tId
spellbind	spellbound	spElb2nd	spElb6nd
race	raced	r1s	r1st
outdate	outdated	6td1t	6td1tId
obliges	obliged	@bl2_Iz	@bl2_d
misinforms	misinformed	"mIsInf$mz	"mIsInf$md
nod	nodded	nQd	nQdId
earth	earthed	3T	3Tt
hurl	hurled	h3l	h3ld
underact	underacted	"Vnd@r{kt	"Vnd@r{ktId
act	acted	{kt	{ktId
yellow	yellowed	jEl5	jEl5d
fogs	fogged	fQgz	fQgd
opposes	opposed	@p5zIz	@p5zd
dismembers	dismembered	dIsmEmb@z	dIsmEmb@d
spin	spun	spIn	spVn
integrates	integrated	IntIgr1ts	IntIgr1tId
sacrifices	sacrificed	s{krIf2sIz	s{krIf2st
seep	seeped	sip	sipt
depart	departed	dIp#t	dIp#tId
reforms	reformed	"rif$mz	"rif$md
scrambles	scrambled	skr{mbPz	skr{mbPd
pervade	pervaded	p@v1d	p@v1dId
forgive	forgave	f@gIv	f@g1v
hampers	hampered	h{mp@z	h{mp@d
paw	pawed	p$	p$d
recite	recited	rIs2t	rIs2tId
lug	lugged	lVg	lVgd
distinguishes	distinguished	dIstINgwISIz	dIstINgwISt
murmur	murmured	m3m@R	m3m@d
brag	bragged	br{g	br{gd
stamp	stamped	st{mp	st{mpt
consummate	consummated	kQns@m1t	kQns@m1tId
make	made	m1k	m1d
slows	slowed	sl5z	sl5d
crimson	crimsoned	krImzH	krImzHd
desists	desisted	dIzIsts	dIzIstId
reconcile	reconciled	rEk@ns2l	rEk@ns2ld
pry	pried	pr2	pr2d
clutches	clutched	klVJIz	klVJt
dismantle	dismantled	dIsm{ntP	dIsm{ntPd
upends	upended	VpEndz	VpEndId
interprets	interpreted	Int3prIts	Int3prItId
tattles	tattled	t{tPz	t{tPd
mistake	mistook	mIst1k	mIstUk
cope	coped	k5p	k5pt
absolves	absolved	@bzQlvz	@bzQlvd
brushes	brushed	brVSIz	brVSt
canalizes	canalized	k{n@l2zIz	k{n@l2zd
slice	sliced	sl2s	sl2st
loses	lost	luzIz	lQst
contaminates	contaminated	k@nt{mIn1ts	k@nt{mIn1tId
protests	protested	pr@tEsts	pr@tEstId
tootle	tootled	tutP	tutPd
laud	lauded	l$d	l$dId
assimilate	assimilated	@sImIl1t	@sImIl1tId
abhor	abhorred	@bh$R	@bh$d
ropes	roped	r5ps	r5pt
unhinge	unhinged	"VnhIn_	"VnhIn_d
purchases	purchased	p3J@sIz	p3J@st
jellies	jellied	_ElIz	_ElId
order	ordered	$d@R	$d@d
link	linked	lINk	lINkt
hemstitches	hemstitched	hEmstIJIz	hEmstIJt
alienates	alienated	1lj@n1ts	1lj@n1tId
proofreads	proofread	prufridz	prufrEd
eases	eased	izIz	izd
connects	connected	k@nEkts	k@nEktId
suffices	sufficed	s@f2sIz	s@f2st
unscrews	unscrewed	"Vnskruz	"Vnskrud
storms	stormed	st$mz	st$md
doses	dosed	d5sIz	d5st
preside	presided	prIz2d	prIz2dId
unpicks	unpicked	"VnpIks	"VnpIkt
repatriate	repatriated	rip{trI1t	rip{trI1tId
beseech	besought	bIsiJ	bIs$t
cinch	cinched	sInJ	sInJt
hogs	hogged	hQgz	hQgd
telescopes	telescoped	tElIsk5ps	tElIsk5pt
massages	massaged	m{s#ZIz	m{s#Zd
peeps	peeped	pips	pipt
slacken	slackened	sl{k@n	sl{k@nd
straggles	straggled	str{gPz	str{gPd
handle	handled	h{ndP	h{ndPd
stiffen	stiffened	stIfH	stIfHd
cling	clung	klIN	klVN
rides	rode	r2dz	r5d
earth	earthed	3T	3Tt
forage	foraged	fQrI_	fQrI_d
mediate	mediated	midI1t	midI1tId
decimates	decimated	dEsIm1ts	dEsIm1tId
swings	swung	swINz	swVN
choose	chose	Juz	J5z
engulf	engulfed	IngVlf	IngVlft
hoax	hoaxed	h5ks	h5kst
blackguards	blackguarded	bl{g#dz	bl{g#dId
lunch	lunched	lVnJ	lVnJt
lasso	lassoed	l{su	l{sud
fleeces	fleeced	flisIz	flist
convolve	convolved	k@nvQlv	k@nvQlvd
soothes	soothed	suDz	suDd
pulverizes	pulverized	pVlv@r2zIz	pVlv@r2zd
reorganizes	reorganized	"ri$g@n2zIz	"ri$g@n2zd
smack	smacked	sm{k	sm{kt
lauds	lauded	l$dz	l$dId
cocoon	cocooned	k@kun	k@kund
evanesces	evanesced	"iv@nEsIz	"iv@nEst
obliterate	obliterated	@blIt@r1t	@blIt@r1tId
laces	laced	l1sIz	l1st
ping	pinged	pIN	pINd
slurps	slurped	sl3ps	sl3pt
wails	wailed	w1lz	w1ld
ruff	ruffed	rVf	rVft
pipes	piped	p2ps	p2pt
memorializes	memorialized	m@m$r7l2zIz	m@m$r7l2zd
mime	mimed	m2m	m2md
bleach	bleached	bliJ	bliJt
appeal	appealed	@pil	@pild
disturb	disturbed	dIst3b	dIst3bd
predestinates	predestinated	"pridEstIn1ts	"pridEstIn1tId
crumble	crumbled	krVmbP	krVmbPd
connect	connected	k@nEkt	k@nEktId
show	showed	S5	S5d
lay	laid	l1	l1d
cards	carded	k#dz	k#dId
swan	swanned	swQn	swQnd
overlaps	overlapped	"5v@l{ps	"5v@l{pt
mollify	mollified	mQlIf2	mQlIf2d
swell	swelled	swEl	swEld
dislikes	disliked	dIsl2ks	dIsl2kt
velarizes	velarized	vil@r2zIz	vil@r2zd
delimitates	delimitated	dIlImIt1ts	dIlImIt1tId
audits	audited	$dIts	$dItId
revise	revised	rIv2z	rIv2zd
hears	heard	h7z	h3d
converses	conversed	k@nv3sIz	k@nv3st
factors	factored	f{kt@z	f{kt@d
nerves	nerved	n3vz	n3vd
harangues	harangued	h@r{Nz	h@r{Nd
overtake	overtook	"5v@t1k	"5v@tUk
dose	dosed	d5s	d5st
prolong	prolonged	pr5lQN	pr5lQNd
howls	howled	h6lz	h6ld
pierces	pierced	p7sIz	p7st
bolster	bolstered	b5lst@R	b5lst@d
tears	tore	t8z	t$R
varnishes	varnished	v#nISIz	v#nISt
thrust	thrust	TrVst	TrVst
dispatches	dispatched	dIsp{JIz	dIsp{Jt
convolves	convolved	k@nvQlvz	k@nvQlvd
decolonizes	decolonized	"dikQl@n2zIz	"dikQl@n2zd
views	viewed	vjuz	vjud
fools	fooled	fulz	fuld
unite	united	jun2t	jun2tId
gift	gifted	gIft	gIftId
argues	argued	#gjuz	#gjud
percolate	percolated	p3k@l1t	p3k@l1tId
placard	placarded	pl{k#d	pl{k#dId
weigh	weighed	w1	w1d
concurs	concurred	k@nk3z	k@nk3d
muff	muffed	mVf	mVft
requests	requested	rIkwEsts	rIkwEstId
diffracts	diffracted	dIfr{kts	dIfr{ktId
obscures	obscured	@bskj9z	@bskj9d
pipes	piped	p2ps	p2pt
releases	released	rIlisIz	rIlist
restrains	restrained	rIstr1nz	rIstr1nd
swaddles	swaddled	swQdPz	swQdPd
speak	spoke	spik	sp5k
notices	noticed	n5tIsIz	n5tIst
retch	retched	rEJ	rEJt
ad-lib	ad-libbed	"{dlIb	"{dlIbd
metamorphose	metamorphosed	"mEt@m$f5z	"mEt@m$f5zd
maim	maimed	m1m	m1md
quick-freezes	quick-froze	kwIkfrizIz	kwIkfr5z
lulls	lulled	lVlz	lVld
pommels	pommelled	pVmPz	pVmPd
pumps	pumped	pVmps	pVmpt
keys	keyed	kiz	kid
splodges	splodged	splQ_Iz	splQ_d
unsex	unsexed	VnsEks	VnsEkst
overman	overmanned	"5v@m{n	"5v@m{nd
miaows	miaowed	mi6z	mi6d
stockpiles	stockpiled	stQkp2lz	stQkp2ld
tootles	tootled	tutPz	tutPd
contemplates	contemplated	kQntEmpl1ts	kQntEmpl1tId
insure	insured	InS$R	InS$d
position	positioned	p@zISH	p@zISHd
salutes	saluted	s@luts	s@lutId
sprinkles	sprinkled	sprINkPz	sprINkPd
simulates	simulated	sImjUl1ts	sImjUl1tId
spades	spaded	sp1dz	sp1dId
breathalyses	breathalysed	brET@l2zIz	brET@l2zd
knits	knit	nIts	nIt
crashes	crashed	kr{SIz	kr{St
teeters	teetered	tit@z	tit@d
radiates	radiated	r1dI1ts	r1dI1tId
divide	divided	dIv2d	dIv2dId
befriends	befriended	bIfrEndz	bIfrEndId
collectivizes	collectivized	k@lEktIv2zIz	k@lEktIv2zd
foxhunts	foxhunted	fQkshVnts	fQkshVntId
fires	fired	f2@z	f2@d
salute	saluted	s@lut	s@lutId
produces	produced	pr@djusIz	pr@djust
honeymoons	honeymooned	hVnImunz	hVnImund
thwarts	thwarted	Tw$ts	Tw$tId
brazes	brazed	br1zIz	br1zd
grow	grew	gr5	gru
content	contented	k@ntEnt	k@ntEntId
paper	papered	p1p@R	p1p@d
abridges	abridged	@brI_Iz	@brI_d
girds	girt	g3dz	g3t
divines	divined	dIv2nz	dIv2nd
spruces	spruced	sprusIz	sprust
dedicate	dedicated	dEdIk1t	dEdIk1tId
near	neared	n7R	n7d
banishes	banished	b{nISIz	b{nISt
refutes	refuted	rIfjuts	rIfjutId
flinch	flinched	flInJ	flInJt
recompense	recompensed	rEk@mpEns	rEk@mpEnst
scowls	scowled	sk6lz	sk6ld
boats	boated	b5ts	b5tId
hasten	hastened	h1sH	h1sHd
boils	boiled	b4lz	b4ld
hastens	hastened	h1sHz	h1sHd
tucks	tucked	tVks	tVkt
tins	tinned	tInz	tInd
chug	chugged	JVg	JVgd
fire	fired	f2@R	f2@d
compares	compared	k@mp8z	k@mp8d
exonerates	exonerated	IgzQn@r1ts	IgzQn@r1tId
butt	butted	bVt	bVtId
divine	divined	dIv2n	dIv2nd
tuck	tucked	tVk	tVkt
repairs	repaired	rIp8z	rIp8d
trephine	trephined	trIfin	trIfind
delay	delayed	dIl1	dIl1d
outlast	outlasted	"6tl#st	"6tl#stId
struggles	struggled	strVgPz	strVgPd
upend	upended	VpEnd	VpEndId
unman	unmanned	"Vnm{n	"Vnm{nd
floor	floored	fl$R	fl$d
tousles	tousled	t6zPz	t6zPd
sticks	stuck	stIks	stVk
ruins	ruined	rUInz	rUInd
unmans	unmanned	"Vnm{nz	"Vnm{nd
comply	complied	k@mpl2	k@mpl2d
pickle	pickled	pIkP	pIkPd
concur	concurred	k@nk3R	k@nk3d
guest	guested	gEst	gEstId
jumps	jumped	_Vmps	_Vmpt
ruin	ruined	rUIn	rUInd
studies	studied	stVdIz	stVdId
towers	towered	t6@z	t6@d
foam	foamed	f5m	f5md
defends	defended	dIfEndz	dIfEndId
kips	kipped	kIps	kIpt
dissuade	dissuaded	dIsw1d	dIsw1dId
pinch	pinched	pInJ	pInJt
ventures	ventured	vEnJ@z	vEnJ@d
converges	converged	k@nv3_Iz	k@nv3_d
mistimes	mistimed	"mIst2mz	"mIst2md
resort	resorted	rIz$t	rIz$tId
hump	humped	hVmp	hVmpt
galumphs	galumphed	g@lVmfs	g@lVmft
obeys	obeyed	@b1z	@b1d
veers	veered	v7z	v7d
favours	favoured	f1v@z	f1v@d
chucks	chucked	JVks	JVkt
bunk	bunked	bVNk	bVNkt
miaow	miaowed	mi6	mi6d
shaves	shove	S1vz	SVv
struggle	struggled	strVgP	strVgPd
thwart	thwarted	Tw$t	Tw$tId
drizzle	drizzled	drIzP	drIzPd
chugs	chugged	JVgz	JVgd
kneel	knelt	nil	nElt
does	did	dVz	dId
modernize	modernized	mQd@n2z	mQd@n2zd
forages	foraged	fQrI_Iz	fQrI_d
lull	lulled	lVl	lVld
anticipate	anticipated	{ntIsIp1t	{ntIsIp1tId
haul	hauled	h$l	h$ld
searches	searched	s3JIz	s3Jt
dedicates	dedicated	dEdIk1ts	dEdIk1tId
founds	founded	f6ndz	f6ndId
ravel	ravelled	r{vP	r{vPd
misdirects	misdirected	"mIsdIrEkts	"mIsdIrEktId
contraindicates	contraindicated	"kQntr@IndIk1ts	"kQntr@IndIk1tId
snores	snored	sn$z	sn$d
bowdlerize	bowdlerized	b6dl@r2z	b6dl@r2zd
stickle	stickled	stIkP	stIkPd
rest	rested	rEst	rEstId
drip-dry	drip-dried	"drIpdr2	"drIpdr2d
scallop	scalloped	skQl@p	skQl@pt
fib	fibbed	fIb	fIbd
profile	profiled	pr5f2l	pr5f2ld
funk	funked	fVNk	fVNkt
pick	picked	pIk	pIkt
radiate	radiated	r1dI1t	r1dI1tId
suckles	suckled	sVkPz	sVkPd
underlines	underlined	"Vnd@l2nz	"Vnd@l2nd
divorce	divorced	dIv$s	dIv$st
displace	displaced	dIspl1s	dIspl1st
mutilate	mutilated	mjutIl1t	mjutIl1tId
breathalyse	breathalysed	brET@l2z	brET@l2zd
rests	rested	rEsts	rEstId
venture	ventured	vEnJ@R	vEnJ@d
clasp	clasped	kl#sp	kl#spt
allocate	allocated	{l5k1t	{l5k1tId
flex	flexed	flEks	flEkst
exterminate	exterminated	Ikst3mIn1t	Ikst3mIn1tId
mean	meant	min	mEnt
mulls	mulled	mVlz	mVld
reunite	reunited	"rijun2t	"rijun2tId
reassure	reassured	"ri@S$R	"ri@S$d
flights	flighted	fl2ts	fl2tId
bathe	bathed	b1D	b1Dd
congests	congested	k@n_Ests	k@n_EstId
prevaricate	prevaricated	prIv{rIk1t	prIv{rIk1tId
merges	merged	m3_Iz	m3_d
instil	instilled	InstIl	InstIld
lassoes	lassoed	l{suz	l{sud
jabbers	jabbered	_{b@z	_{b@d
interviews	interviewed	Int@vjuz	Int@vjud
fosters	fostered	fQst@z	fQst@d
stockpile	stockpiled	stQkp2l	stQkp2ld
exacerbate	exacerbated	Igz{s@b1t	Igz{s@b1tId
counters	countered	k6nt@z	k6nt@d
pronounces	pronounced	pr@n6nsIz	pr@n6nst
overdraw	overdrew	"5v@dr$	"5v@dru
gird	girt	g3d	g3t
foxhunt	foxhunted	fQkshVnt	fQkshVntId
vaporize	vaporized	v1p@r2z	v1p@r2zd
rollicks	rollicked	rQlIks	rQlIkt
radiates	radiated	r1dI1ts	r1dI1tId
maximize	maximized	m{ksIm2z	m{ksIm2zd
grizzle	grizzled	grIzP	grIzPd
induce	induced	Indjus	Indjust
hush	hushed	hVS	hVSt
flounders	floundered	fl6nd@z	fl6nd@d
relinquish	relinquished	rIlINkwIS	rIlINkwISt
bathes	bathed	b1Dz	b1Dd
sicken	sickened	sIk@n	sIk@nd
gazump	gazumped	g@zVmp	g@zVmpt
quarter	quartered	kw$t@R	kw$t@d
proportion	proportioned	pr@p$SH	pr@p$SHd
grows	grew	gr5z	gru
free	freed	fri	frid
spruce	spruced	sprus	sprust
dry	dried	dr2	dr2d
frightens	frightened	fr2tHz	fr2tHd
intends	intended	IntEndz	IntEndId
stymie	stymied	st2mI	st2mId
humps	humped	hVmps	hVmpt
firms	firmed	f3mz	f3md
veer	veered	v7R	v7d
samples	sampled	s#mpPz	s#mpPd
fasts	fasted	f#sts	f#stId
prevaricates	prevaricated	prIv{rIk1ts	prIv{rIk1tId
institutes	instituted	InstItjuts	InstItjutId
downgrade	downgraded	d6ngr1d	d6ngr1dId
favour	favoured	f1v@R	f1v@d
instils	instilled	InstIlz	InstIld
nonplusses	nonplussed	"nQnplVsIz	"nQnplVst
chews	chewed	Juz	Jud
expend	expended	IkspEnd	IkspEndId
key	keyed	ki	kid
overcharges	overcharged	"5v@J#_Iz	"5v@J#_d
consult	consulted	k@nsVlt	k@nsVltId
models	modelled	mQdPz	mQdPd
bribe	bribed	br2b	br2bd
tin	tinned	tIn	tInd
spread	spread	sprEd	sprEd
visualizes	visualized	vIZ9l2zIz	vIZ9l2zd
mistime	mistimed	"mIst2m	"mIst2md
flags	flagged	fl{gz	fl{gd
banish	banished	b{nIS	b{nISt
blackmails	blackmailed	bl{km1lz	bl{km1ld
electioneer	electioneered	I"lEkS@n7R	I"lEkS@n7d
picks	picked	pIks	pIkt
monitors	monitored	mQnIt@z	mQnIt@d
kicks	kicked	kIks	kIkt
flag	flagged	fl{g	fl{gd
grasp	grasped	gr#sp	gr#spt
suspects	suspected	s@spEkts	s@spEktId
locks	locked	lQks	lQkt
associate	associated	@s5SI1t	@s5SI1tId
dries	dried	dr2z	dr2d
ranks	ranked	r{Nks	r{Nkt
expends	expended	IkspEndz	IkspEndId
erupt	erupted	IrVpt	IrVptId
teeter	teetered	tit@R	tit@d
bedevils	bedevilled	bIdEvPz	bIdEvPd
radiate	radiated	r1dI1t	r1dI1tId
pauperizes	pauperized	p$p@r2zIz	p$p@r2zd
circles	circled	s3kPz	s3kPd
redo	redid	"ridu	"ridId
desire	desired	dIz2@R	dIz2@d
beautifies	beautified	bjutIf2z	bjutIf2d
survive	survived	s@v2v	s@v2vd
upends	upended	VpEndz	VpEndId
contrast	contrasted	k@ntr#st	k@ntr#stId
terms	termed	t3mz	t3md
pronounce	pronounced	pr@n6ns	pr@n6nst
jewel	jewelled	_u@l	_u@ld
regrets	regretted	rIgrEts	rIgrEtId
papers	papered	p1p@z	p1p@d
top	topped	tQp	tQpt
frees	freed	friz	frid
prepare	prepared	prIp8R	prIp8d
reunites	reunited	"rijun2ts	"rijun2tId
apologizes	apologized	@pQl@_2zIz	@pQl@_2zd
bridle	bridled	br2dP	br2dPd
instigates	instigated	InstIg1ts	InstIg1tId
sickens	sickened	sIk@nz	sIk@nd
beautify	beautified	bjutIf2	bjutIf2d
intend	intended	IntEnd	IntEndId
foal	foaled	f5l	f5ld
trundles	trundled	trVndPz	trVndPd
stymies	stymied	st2mIz	st2mId
tousle	tousled	t6zP	t6zPd
controls	controlled	k@ntr5lz	k@ntr5ld
dwindles	dwindled	dwIndPz	dwIndPd
contrasts	contrasted	k@ntr#sts	k@ntr#stId
empty	emptied	EmptI	EmptId
re-forms	re-formed	"rif$mz	"rif$md
shuffle	shuffled	SVfP	SVfPd
fast	fasted	f#st	f#stId
faint	fainted	f1nt	f1ntId
annihilate	annihilated	@n2@l1t	@n2@l1tId
pickles	pickled	pIkPz	pIkPd
trundle	trundled	trVndP	trVndPd
rollick	rollicked	rQlIk	rQlIkt
catalogue	catalogued	k{t@lQg	k{t@lQgd
overdevelop	overdeveloped	"5v@dIvEl@p	"5v@dIvEl@pt
long	longed	lQN	lQNd
contraindicate	contraindicated	"kQntr@IndIk1t	"kQntr@IndIk1tId
produce	produced	pr@djus	pr@djust
exonerate	exonerated	IgzQn@r1t	IgzQn@r1tId
welsh	welshed	wElS	wElSt
spade	spaded	sp1d	sp1dId
punch	punched	pVnJ	pVnJt
preserve	preserved	prIz3v	prIz3vd
complies	complied	k@mpl2z	k@mpl2d
darn	darned	d#n	d#nd
darns	darned	d#nz	d#nd
anticipates	anticipated	{ntIsIp1ts	{ntIsIp1tId
relinquishes	relinquished	rIlINkwISIz	rIlINkwISt
profiles	profiled	pr5f2lz	pr5f2ld
interests	interested	Intr@sts	Intr@stId
remember	remembered	rImEmb@R	rImEmb@d
repair	repaired	rIp8R	rIp8d
smoke	smoked	sm5k	sm5kt
instigate	instigated	InstIg1t	InstIg1tId
bowdlerizes	bowdlerized	b6dl@r2zIz	b6dl@r2zd
galumph	galumphed	g@lVmf	g@lVmft
displease	displeased	dIspliz	dIsplizd
shut	shut	SVt	SVt
racketeers	racketeered	"r{k@t7z	"r{k@t7d
overcharge	overcharged	"5v@J#_	"5v@J#_d
inhibits	inhibited	InhIbIts	InhIbItId
jellies	jellied	_ElIz	_ElId
divides	divided	dIv2dz	dIv2dId
resorts	resorted	rIz$ts	rIz$tId
honeymoon	honeymooned	hVnImun	hVnImund
annihilates	annihilated	@n2@l1ts	@n2@l1tId
hazard	hazarded	h{z@d	h{z@dId
stencil	stencilled	stEnsP	stEnsPd
collect	collected	k@lEkt	k@lEktId
impede	impeded	Impid	ImpidId
flexes	flexed	flEksIz	flEkst
outlasts	outlasted	"6tl#sts	"6tl#stId
hushes	hushed	hVSIz	hVSt
loans	loaned	l5nz	l5nd
formulate	formulated	f$mjUl1t	f$mjUl1tId
maim	maimed	m1m	m1md
circle	circled	s3kP	s3kPd
overdraws	overdrew	"5v@dr$z	"5v@dru
hurts	hurt	h3ts	h3t
laughs	laughed	l#fs	l#ft
delays	delayed	dIl1z	dIl1d
televises	televised	tElIv2zIz	tElIv2zd
summons	summonsed	sVm@nz	sVm@nzd
means	meant	minz	mEnt
transubstantiate	transubstantiated	"tr{ns@bst{nSI1t	"tr{ns@bst{nSI1tId
hurt	hurt	h3t	h3t
empties	emptied	EmptIz	EmptId
converge	converged	k@nv3_	k@nv3_d
stickles	stickled	stIkPz	stIkPd
frames	framed	fr1mz	fr1md
excludes	excluded	Ikskludz	IkskludId
snicks	snicked	snIks	snIkt
clinches	clinched	klInJIz	klInJt
campaigns	campaigned	k{mp1nz	k{mp1nd
verbalize	verbalized	v3b@l2z	v3b@l2zd
compare	compared	k@mp8R	k@mp8d
shower	showered	S6@R	S6@d
formulates	formulated	f$mjUl1ts	f$mjUl1tId
firm	firmed	f3m	f3md
befriend	befriended	bIfrEnd	bIfrEndId
pauperize	pauperized	p$p@r2z	p$p@r2zd
hazards	hazarded	h{z@dz	h{z@dId
trespasses	trespassed	trEsp@sIz	trEsp@st
rallies	rallied	r{lIz	r{lId
tango	tangoed	t{Ng5	t{Ng5d
gravel	gravelled	gr{vP	gr{vPd
tap-dance	tap-danced	t{pd#ns	t{pd#nst
plants	planted	pl#nts	pl#ntId
consults	consulted	k@nsVlts	k@nsVltId
butts	butted	bVts	bVtId
clinch	clinched	klInJ	klInJt
impedes	impeded	Impidz	ImpidId
dominates	dominated	dQmIn1ts	dQmIn1tId
monitor	monitored	mQnIt@R	mQnIt@d
summon	summoned	sVm@n	sVm@nd
overmans	overmanned	"5v@m{nz	"5v@m{nd
congest	congested	k@n_Est	k@n_EstId
scowl	scowled	sk6l	sk6ld
sweeten	sweetened	switH	switHd
floors	floored	fl$z	fl$d
sweeps	swept	swips	swEpt
hurtle	hurtled	h3tP	h3tPd
disguises	disguised	dIsg2zIz	dIsg2zd
gazumps	gazumped	g@zVmps	g@zVmpt
collects	collected	k@lEkts	k@lEktId
wiretap	wiretapped	w2@t{p	w2@t{pt
exacerbates	exacerbated	Igz{s@b1ts	Igz{s@b1tId
affirm	affirmed	@f3m	@f3md
study	studied	stVdI	stVdId
redeem	redeemed	rIdim	rIdimd
suspect	suspected	s@spEkt	s@spEktId
proportions	proportioned	pr@p$SHz	pr@p$SHd
ordains	ordained	$d1nz	$d1nd
grease	greased	griz	grizd
welshes	welshed	wElSIz	wElSt
outruns	outran	"6trVnz	"6tr{n
incarnates	incarnated	Ink#n1ts	Ink#n1tId
interest	interested	Intr@st	Intr@stId
maximizes	maximized	m{ksIm2zIz	m{ksIm2zd
swivel	swivelled	swIvP	swIvPd
misquote	misquoted	"mIskw5t	"mIskw5tId
sample	sampled	s#mpP	s#mpPd
verbalizes	verbalized	v3b@l2zIz	v3b@l2zd
rules	ruled	rulz	ruld
affirms	affirmed	@f3mz	@f3md
refute	refuted	rIfjut	rIfjutId
insures	insured	InS$z	InS$d
reassures	reassured	"ri@S$z	"ri@S$d
cops	copped	kQps	kQpt
control	controlled	k@ntr5l	k@ntr5ld
dwindle	dwindled	dwIndP	dwIndPd
nears	neared	n7z	n7d
drip-dries	drip-dried	"drIpdr2z	"drIpdr2d
consolidates	consolidated	k@nsQlId1ts	k@nsQlId1tId
jabber	jabbered	_{b@R	_{b@d
compromise	compromised	kQmpr@m2z	kQmpr@m2zd
downgrades	downgraded	d6ngr1dz	d6ngr1dId
laugh	laughed	l#f	l#ft
contemplate	contemplated	kQntEmpl1t	kQntEmpl1tId
dominate	dominated	dQmIn1t	dQmIn1tId
erupts	erupted	IrVpts	IrVptId
associates	associated	@s5SI1ts	@s5SI1tId
rots	rotted	rQts	rQtId
longs	longed	lQNz	lQNd
populate	populated	pQpjUl1t	pQpjUl1tId
rank	ranked	r{Nk	r{Nkt
overdevelops	overdeveloped	"5v@dIvEl@ps	"5v@dIvEl@pt
incarnate	incarnated	Ink#n1t	Ink#n1tId
fry	fried	fr2	fr2d
belittles	belittled	bIlItPz	bIlItPd
approaches	approached	@pr5JIz	@pr5Jt
positions	positioned	p@zISHz	p@zISHd
rot	rotted	rQt	rQtId
merit	merited	mErIt	mErItId
merge	merged	m3_	m3_d
embrocates	embrocated	Embr5k1ts	Embr5k1tId
shave	shove	S1v	SVv
outrun	outran	"6trVn	"6tr{n
foams	foamed	f5mz	f5md
quick-freeze	quick-froze	kwIkfriz	kwIkfr5z
collectivize	collectivized	k@lEktIv2z	k@lEktIv2zd
jump	jumped	_Vmp	_Vmpt
showers	showered	S6@z	S6@d
dower	dowered	d6@R	d6@d
offsets	offset	QfsEts	QfsEt
shuffles	shuffled	SVfPz	SVfPd
entertain	entertained	"Ent@t1n	"Ent@t1nd
mills	milled	mIlz	mIld
averages	averaged	{v@rI_Iz	{v@rI_d
mull	mulled	mVl	mVld
tower	towered	t6@R	t6@d
foals	foaled	f5lz	f5ld
burrows	burrowed	bVr5z	bVr5d
sprinkle	sprinkled	sprINkP	sprINkPd
braze	brazed	br1z	br1zd
boat	boated	b5t	b5tId
transubstantiates	transubstantiated	"tr{ns@bst{nSI1ts	"tr{ns@bst{nSI1tId
bribes	bribed	br2bz	br2bd
misquotes	misquoted	"mIskw5ts	"mIskw5tId
divorces	divorced	dIv$sIz	dIv$st
impounds	impounded	Imp6ndz	Imp6ndId
awakens	awoke	@w1k@nz	@w5k
displaces	displaced	dIspl1sIz	dIspl1st
wait	waited	w1t	w1tId
cracks	cracked	kr{ks	kr{kt
trephines	trephined	trIfinz	trIfind
maims	maimed	m1mz	m1md
cop	copped	kQp	kQpt
awaken	awoke	@w1k@n	@w5k
misdirect	misdirected	"mIsdIrEkt	"mIsdIrEktId
lock	locked	lQk	lQkt
jelly	jellied	_ElI	_ElId
exclude	excluded	Iksklud	IkskludId
bunks	bunked	bVNks	bVNkt
hitchhike	hitchhiked	hIJh2k	hIJh2kt
cranes	craned	kr1nz	kr1nd
loan	loaned	l5n	l5nd
evinces	evinced	IvInsIz	IvInst
vaporizes	vaporized	v1p@r2zIz	v1p@r2zd
borrow	borrowed	bQr5	bQr5d
contents	contented	k@ntEnts	k@ntEntId
displeases	displeased	dIsplizIz	dIsplizd
sandpaper	sandpapered	s{nd"p1p@R	s{nd"p1p@d
chew	chewed	Ju	Jud
dehumanize	dehumanized	"dihjum@n2z	"dihjum@n2zd
crash	crashed	kr{S	kr{St
rule	ruled	rul	ruld
trespass	trespassed	trEsp@s	trEsp@st
heralds	heralded	hEr@ldz	hEr@ldId
effectuates	effectuated	IfEktjU1ts	IfEktjU1tId
dress	dressed	drEs	drEst
sandpapers	sandpapered	s{nd"p1p@z	s{nd"p1p@d
evince	evinced	IvIns	IvInst
redoes	redid	"ridVz	"ridId
campaign	campaigned	k{mp1n	k{mp1nd
regret	regretted	rIgrEt	rIgrEtId
prepares	prepared	prIp8z	prIp8d
recompenses	recompensed	rEk@mpEnsIz	rEk@mpEnst
populates	populated	pQpjUl1ts	pQpjUl1tId
redeems	redeemed	rIdimz	rIdimd
quarters	quartered	kw$t@z	kw$t@d
kip	kipped	kIp	kIpt
drizzles	drizzled	drIzPz	drIzPd
racketeer	racketeered	"r{k@t7R	"r{k@t7d
term	termed	t3m	t3md
plead	pled	plid	plEd
blackmail	blackmailed	bl{km1l	bl{km1ld
countermarch	countermarched	k6nt@m#J	k6nt@m#Jt
sweetens	sweetened	switHz	switHd
gravels	gravelled	gr{vPz	gr{vPd
kick	kicked	kIk	kIkt
shuts	shut	SVts	SVt
foster	fostered	fQst@R	fQst@d
blush	blushed	blVS	blVSt
hauls	hauled	h$lz	h$ld
preserves	preserved	prIz3vz	prIz3vd
counter	countered	k6nt@R	k6nt@d
rally	rallied	r{lI	r{lId
catalogues	catalogued	k{t@lQgz	k{t@lQgd
guests	guested	gEsts	gEstId
inhibit	inhibited	InhIbIt	InhIbItId
fries	fried	fr2z	fr2d
belittle	belittled	bIlItP	bIlItPd
jewels	jewelled	_u@lz	_u@ld
kneels	knelt	nilz	nElt
re-form	re-formed	"rif$m	"rif$md
model	modelled	mQdP	mQdPd
prescribe	prescribed	prIskr2b	prIskr2bd
ordain	ordained	$d1n	$d1nd
crane	craned	kr1n	kr1nd
establishes	established	Ist{blISIz	Ist{blISt
blushes	blushed	blVSIz	blVSt
scallops	scalloped	skQl@ps	skQl@pt
approach	approached	@pr5J	@pr5Jt
knit	knit	nIt	nIt
compromises	compromised	kQmpr@m2zIz	kQmpr@m2zd
crack	cracked	kr{k	kr{kt
tops	topped	tQps	tQpt
allocates	allocated	{l5k1ts	{l5k1tId
chuck	chucked	JVk	JVkt
sweep	swept	swip	swEpt
electioneers	electioneered	I"lEkS@n7z	I"lEkS@n7d
bedevil	bedevilled	bIdEvP	bIdEvPd
torments	tormented	t$mEnts	t$mEntId
stencils	stencilled	stEnsPz	stEnsPd
induces	induced	IndjusIz	Indjust
prescribes	prescribed	prIskr2bz	prIskr2bd
extol	extolled	Ikst5l	Ikst5ld
entertains	entertained	"Ent@t1nz	"Ent@t1nd
flight	flighted	fl2t	fl2tId
stick	stuck	stIk	stVk
burrow	burrowed	bVr5	bVr5d
televise	televised	tElIv2z	tElIv2zd
funks	funked	fVNks	fVNkt
hut	hutted	hVt	hVtId
concurs	concurred	k@nk3z	k@nk3d
batter	battered	b{t@R	b{t@d
nonplus	nonplussed	"nQnplVs	"nQnplVst
effectuate	effectuated	IfEktjU1t	IfEktjU1tId
found	founded	f6nd	f6ndId
crisscross	crisscrossed	krIskrQs	krIskrQst
faints	fainted	f1nts	f1ntId
countermarches	countermarched	k6nt@m#JIz	k6nt@m#Jt
swivels	swivelled	swIvPz	swIvPd
boil	boiled	b4l	b4ld
mill	milled	mIl	mIld
institute	instituted	InstItjut	InstItjutId
hurtles	hurtled	h3tPz	h3tPd
tap-dances	tap-danced	t{pd#nsIz	t{pd#nst
humbug	humbugged	hVmbVg	hVmbVgd
pinches	pinched	pInJIz	pInJt
desires	desired	dIz2@z	dIz2@d
plant	planted	pl#nt	pl#ntId
bridles	bridled	br2dPz	br2dPd
generates	generated	_En@r1ts	_En@r1tId
dehumanizes	dehumanized	"dihjum@n2zIz	"dihjum@n2zd
apologize	apologized	@pQl@_2z	@pQl@_2zd
herald	heralded	hEr@ld	hEr@ldId
spreads	spread	sprEdz	sprEd
unsexes	unsexed	VnsEksIz	VnsEkst
punches	punched	pVnJIz	pVnJt
dowers	dowered	d6@z	d6@d
mutilates	mutilated	mjutIl1ts	mjutIl1tId
grizzles	grizzled	grIzPz	grIzPd
hitchhikes	hitchhiked	hIJh2ks	hIJh2kt
disguise	disguised	dIsg2z	dIsg2zd
dissuades	dissuaded	dIsw1dz	dIsw1dId
exterminates	exterminated	Ikst3mIn1ts	Ikst3mIn1tId
search	searched	s3J	s3Jt
impound	impounded	Imp6nd	Imp6ndId
simulate	simulated	sImjUl1t	sImjUl1tId
interview	interviewed	Int@vju	Int@vjud
frighten	frightened	fr2tH	fr2tHd
pleads	pled	plidz	plEd
visualize	visualized	vIZ9l2z	vIZ9l2zd
do	did	du	dId
humbugs	humbugged	hVmbVgz	hVmbVgd
tools	tooled	tulz	tuld
flounder	floundered	fl6nd@R	fl6nd@d
pommel	pommelled	pVmP	pVmPd
crisscrosses	crisscrossed	krIskrQsIz	krIskrQst
extols	extolled	Ikst5lz	Ikst5ld
snick	snicked	snIk	snIkt
ravels	ravelled	r{vPz	r{vPd
obey	obeyed	@b1	@b1d
waits	waited	w1ts	w1tId
forage	foraged	fQrI_	fQrI_d
modernizes	modernized	mQd@n2zIz	mQd@n2zd
fibs	fibbed	fIbz	fIbd
wiretaps	wiretapped	w2@t{ps	w2@t{pt
tootle	tootled	tutP	tutPd
suckle	suckled	sVkP	sVkPd
splodge	splodged	splQ_	splQ_d
flinches	flinched	flInJIz	flInJt
huts	hutted	hVts	hVtId
grasps	grasped	gr#sps	gr#spt
frame	framed	fr1m	fr1md
tool	tooled	tul	tuld
remembers	remembered	rImEmb@z	rImEmb@d
offset	offset	QfsEt	QfsEt
batters	battered	b{t@z	b{t@d
abridge	abridged	@brI_	@brI_d
greases	greased	grizIz	grizd
torment	tormented	t$mEnt	t$mEntId
average	averaged	{v@rI_	{v@rI_d
snore	snored	sn$R	sn$d
exhale	exhaled	Eksh1l	Eksh1ld
braids	braided	br1dz	br1dId
generate	generated	_En@r1t	_En@r1tId
merits	merited	mErIts	mErItId
consolidate	consolidated	k@nsQlId1t	k@nsQlId1tId
establish	established	Ist{blIS	Ist{blISt
clasps	clasped	kl#sps	kl#spt
exhales	exhaled	Eksh1lz	Eksh1ld
braid	braided	br1d	br1dId
embrocate	embrocated	Embr5k1t	Embr5k1tId
smokes	smoked	sm5ks	sm5kt
underline	underlined	"Vnd@l2n	"Vnd@l2nd
survives	survived	s@v2vz	s@v2vd
borrows	borrowed	bQr5z	bQr5d
pump	pumped	pVmp	pVmpt
defend	defended	dIfEnd	dIfEndId
dresses	dressed	drEsIz	drEst
lasso	lassoed	l{su	l{sud
